//MAP CONVERTED BY dmm2tgm.py THIS HEADER COMMENT PREVENTS RECONVERSION, DO NOT REMOVE
"aO" = (
/obj/effect/decal/cleanable/sigil/N,
/obj/machinery/light/rogue/wallfire/candle/blue,
/turf/open/floor/rogue/ruinedwood/spiral,
/area/rogue)
"aY" = (
/obj/machinery/light/rogue/wallfire/candle/blue,
/obj/structure/table/vtable,
/obj/item/storage/belt/rogue/pouch,
/turf/open/floor/rogue/ruinedwood/spiral,
/area/rogue)
"bv" = (
/turf/open/floor/rogue/rooftop{
	dir = 4
	},
/area/rogue)
"bO" = (
/obj/item/bath/soap{
	pixel_y = -5
	},
/obj/structure/mineral_door/wood/fancywood{
	locked = 1
	},
/turf/open/floor/rogue/ruinedwood/spiral,
/area/rogue)
"cO" = (
/turf/open/floor/rogue/tile,
/area/rogue)
"cV" = (
/obj/item/roguecoin/copper/pile,
/turf/open/water/bath,
/area/rogue)
"dh" = (
/obj/structure/stairs/d,
/turf/open/floor/rogue/ruinedwood/spiral,
/area/rogue)
"dT" = (
/obj/effect/decal/cleanable/sigil/NW,
/turf/open/floor/rogue/ruinedwood/spiral,
/area/rogue)
"gI" = (
/obj/structure/stairs,
/turf/open/floor/rogue/tile,
/area/rogue)
"hR" = (
/obj/machinery/light/rogue/wallfire/candle/blue/r,
/turf/open/floor/rogue/ruinedwood/spiral,
/area/rogue)
"kc" = (
/obj/item/bath/soap{
	pixel_y = -5
	},
/obj/item/roguecoin/copper/pile,
/turf/open/water/bath,
/area/rogue)
"kJ" = (
/mob/living/simple_animal/hostile/rogue/skeleton/spear,
/obj/item/roguecoin/copper/pile,
/turf/open/water/bath,
/area/rogue)
"mh" = (
/obj/structure/closet/crate/roguecloset/inn,
/mob/living/simple_animal/hostile/rogue/skeleton/guard,
/turf/open/floor/rogue/ruinedwood/spiral,
/area/rogue)
"mx" = (
/obj/effect/decal/cleanable/sigil/SW,
/turf/open/floor/rogue/ruinedwood/spiral,
/area/rogue)
"mF" = (
/turf/open/floor/rogue/dirt,
/area/rogue)
"nn" = (
/mob/living/simple_animal/hostile/rogue/skeleton/guard,
/turf/open/floor/rogue/ruinedwood/spiral,
/area/rogue)
"nu" = (
/turf/open/floor/rogue/rooftop{
	dir = 8
	},
/area/rogue)
"nx" = (
/obj/machinery/light/rogue/wallfire/candle/blue,
/obj/structure/rack/rogue/shelf/big,
/obj/item/perfume/random{
	pixel_y = 25
	},
/obj/item/perfume/random{
	pixel_y = 23;
	pixel_x = 14
	},
/turf/open/floor/rogue/ruinedwood/spiral,
/area/rogue)
"oY" = (
/obj/structure/mineral_door/swing_door,
/obj/item/bath/soap{
	pixel_y = -5
	},
/turf/open/floor/rogue/tile,
/area/rogue)
"pA" = (
/obj/structure/rack/rogue/shelf/big,
/obj/item/perfume/random{
	pixel_y = 24
	},
/obj/item/perfume/random{
	pixel_y = 24;
	pixel_x = 12
	},
/turf/open/floor/rogue/ruinedwood/spiral,
/area/rogue)
"pQ" = (
/obj/effect/decal/cleanable/sigil/W,
/turf/open/floor/rogue/ruinedwood/spiral,
/area/rogue)
"pR" = (
/turf/open/floor/rogue/ruinedwood/spiral,
/area/rogue)
"rS" = (
/obj/item/soap{
	pixel_x = -3;
	pixel_y = -5
	},
/obj/structure/mineral_door/swing_door,
/turf/open/floor/rogue/ruinedwood/spiral,
/area/rogue)
"sm" = (
/obj/item/roguecoin/copper/pile,
/turf/open/floor/rogue/tile,
/area/rogue)
"tJ" = (
/obj/structure/rack/rogue/shelf/big,
/obj/item/perfume/random{
	pixel_y = 24
	},
/obj/item/perfume/random{
	pixel_x = 12;
	pixel_y = 27
	},
/turf/open/floor/rogue/ruinedwood/spiral,
/area/rogue)
"uR" = (
/turf/open/floor/rogue/rooftop{
	dir = 1
	},
/area/rogue)
"vx" = (
/mob/living/simple_animal/hostile/rogue/skeleton/bow,
/turf/open/floor/rogue/tile,
/area/rogue)
"wQ" = (
/obj/effect/decal/cleanable/sigil/E,
/turf/open/floor/rogue/ruinedwood/spiral,
/area/rogue)
"xx" = (
/obj/machinery/light/rogue/wallfire/candle/blue,
/turf/open/water/bath,
/area/rogue)
"Ao" = (
/obj/machinery/light/rogue/wallfire/candle/blue,
/obj/structure/closet/crate/drawer/inn,
/turf/open/floor/rogue/ruinedwood/spiral,
/area/rogue)
"BX" = (
/mob/living/simple_animal/hostile/rogue/skeleton/spear,
/turf/open/water/bath,
/area/rogue)
"CA" = (
/obj/item/storage/belt/rogue/pouch,
/obj/structure/table/vtable/v2,
/turf/open/floor/rogue/ruinedwood/spiral,
/area/rogue)
"CU" = (
/obj/effect/decal/cleanable/sigil/S,
/turf/open/floor/rogue/ruinedwood/spiral,
/area/rogue)
"Ey" = (
/turf/closed/wall/mineral/rogue/decowood,
/area/rogue)
"EQ" = (
/obj/structure/table/vtable,
/obj/item/rogueweapon/knife/dagger/silver{
	pixel_y = 8;
	pixel_x = 6
	},
/turf/open/floor/rogue/ruinedwood/spiral,
/area/rogue)
"Fx" = (
/obj/structure/bed/rogue/inn/double,
/obj/item/bedsheet/rogue/fabric_double,
/turf/open/floor/rogue/ruinedwood/spiral,
/area/rogue)
"FL" = (
/obj/effect/decal/cleanable/sigil/NE,
/turf/open/floor/rogue/ruinedwood/spiral,
/area/rogue)
"Gb" = (
/obj/structure/mineral_door/wood/fancywood{
	locked = 1
	},
/turf/open/floor/rogue/ruinedwood/spiral,
/area/rogue)
"Gp" = (
/mob/living/simple_animal/hostile/rogue/skeleton/bow,
/turf/open/floor/rogue/ruinedwood/spiral,
/area/rogue)
"Hv" = (
/obj/structure/mineral_door/swing_door,
/turf/open/floor/rogue/tile,
/area/rogue)
"JI" = (
/turf/open/water/swamp/deep,
/area/rogue)
"Ko" = (
/obj/machinery/light/rogue/wallfire/candle/blue,
/obj/structure/bed/rogue/shit,
/mob/living/simple_animal/hostile/rogue/skeleton,
/turf/open/floor/rogue/ruinedwood/spiral,
/area/rogue)
"KT" = (
/obj/structure/rack/rogue/shelf/big,
/obj/item/perfume/random{
	pixel_y = 25
	},
/obj/item/perfume/random{
	pixel_y = 27;
	pixel_x = 13
	},
/turf/open/floor/rogue/ruinedwood/spiral,
/area/rogue)
"Mj" = (
/obj/machinery/light/rogue/wallfire/candle/blue,
/mob/living/simple_animal/hostile/rogue/skeleton/spear,
/turf/open/water/bath,
/area/rogue)
"Ph" = (
/obj/structure/table/vtable/v2,
/obj/item/rogueweapon/knife/dagger/silver{
	pixel_y = 3;
	pixel_x = -3
	},
/obj/item/reagent_containers/powder/moondust,
/obj/item/reagent_containers/powder/moondust{
	pixel_y = 10;
	pixel_x = -13
	},
/obj/item/reagent_containers/powder/moondust{
	pixel_y = 10;
	pixel_x = 10
	},
/turf/open/floor/rogue/ruinedwood/spiral,
/area/rogue)
"PM" = (
/obj/effect/decal/cleanable/sigil,
/obj/item/reagent_containers/powder/ozium{
	pixel_y = 2
	},
/obj/item/reagent_containers/powder/ozium{
	pixel_y = 15;
	pixel_x = -19
	},
/obj/item/reagent_containers/powder/ozium{
	pixel_y = 23
	},
/obj/item/reagent_containers/powder/ozium{
	pixel_y = 14;
	pixel_x = 21
	},
/obj/item/reagent_containers/powder/ozium{
	pixel_y = -12;
	pixel_x = -13
	},
/obj/item/reagent_containers/powder/ozium{
	pixel_y = -13;
	pixel_x = 14
	},
/turf/open/floor/rogue/ruinedwood/spiral,
/area/rogue)
"PQ" = (
/obj/machinery/light/rogue/wallfire/candle/blue/l,
/turf/open/floor/rogue/ruinedwood/spiral,
/area/rogue)
"Qs" = (
/obj/effect/decal/cleanable/sigil/SE,
/turf/open/floor/rogue/ruinedwood/spiral,
/area/rogue)
"Qw" = (
/turf/open/floor/rogue/naturalstone,
/area/rogue)
"RG" = (
/turf/closed/mineral/rogue/bedrock,
/area/rogue)
"TQ" = (
/turf/open/transparent/openspace,
/area/rogue)
"UB" = (
/obj/item/bath/soap{
	pixel_y = -5
	},
/turf/open/water/bath,
/area/rogue)
"UT" = (
/turf/open/water/bath,
/area/rogue)
"Vw" = (
/mob/living/carbon/human/species/zizombie/npc/militiamen,
/turf/open/floor/rogue/ruinedwood/spiral,
/area/rogue)
"Yr" = (
/turf/open/floor/rogue/rooftop,
/area/rogue)
"Yy" = (
/obj/machinery/light/rogue/wallfire/candle/blue,
/turf/open/floor/rogue/tile,
/area/rogue)
"YP" = (
/obj/structure/bed/rogue/shit,
/mob/living/simple_animal/hostile/rogue/skeleton,
/turf/open/floor/rogue/ruinedwood/spiral,
/area/rogue)
"YZ" = (
/turf/closed/wall/mineral/rogue/decowood/vert,
/area/rogue)
"Zi" = (
/turf/closed/indestructible/roguewindow,
/area/rogue)

(1,1,1) = {"
RG
RG
RG
RG
RG
RG
RG
RG
RG
mF
mF
RG
RG
RG
RG
RG
RG
RG
RG
RG
"}
(2,1,1) = {"
RG
mF
mF
mF
mF
mF
mF
mF
mF
mF
mF
mF
mF
mF
mF
mF
mF
mF
mF
RG
"}
(3,1,1) = {"
RG
mF
JI
JI
JI
JI
JI
JI
JI
JI
JI
JI
JI
JI
JI
JI
JI
JI
mF
RG
"}
(4,1,1) = {"
RG
mF
JI
YZ
YZ
YZ
YZ
YZ
YZ
JI
JI
YZ
YZ
YZ
YZ
YZ
YZ
JI
mF
RG
"}
(5,1,1) = {"
RG
mF
JI
YZ
BX
UT
UB
cO
Hv
JI
JI
Hv
cO
UB
BX
kJ
YZ
JI
mF
RG
"}
(6,1,1) = {"
RG
mF
JI
YZ
UB
UT
UT
cO
YZ
JI
JI
YZ
Yy
UT
UT
UT
YZ
JI
mF
RG
"}
(7,1,1) = {"
RG
mF
JI
YZ
Mj
UT
UT
cO
YZ
JI
JI
YZ
cO
UT
UB
UT
YZ
JI
mF
RG
"}
(8,1,1) = {"
RG
mF
JI
YZ
cO
cO
cO
sm
YZ
JI
JI
YZ
cO
cO
cO
cO
YZ
JI
mF
RG
"}
(9,1,1) = {"
RG
mF
JI
YZ
oY
YZ
YZ
YZ
cO
vx
cO
cO
YZ
YZ
YZ
oY
YZ
JI
mF
RG
"}
(10,1,1) = {"
mF
mF
JI
JI
JI
JI
JI
JI
cO
gI
YZ
vx
JI
JI
JI
JI
JI
JI
mF
mF
"}
(11,1,1) = {"
mF
mF
JI
JI
JI
JI
JI
JI
vx
gI
YZ
cO
JI
JI
JI
JI
JI
JI
mF
mF
"}
(12,1,1) = {"
RG
mF
JI
YZ
Hv
YZ
YZ
YZ
cO
vx
cO
cO
YZ
YZ
YZ
Hv
YZ
JI
mF
RG
"}
(13,1,1) = {"
RG
mF
JI
YZ
cO
cO
cO
cO
YZ
JI
JI
YZ
cO
cO
cO
cO
YZ
JI
mF
RG
"}
(14,1,1) = {"
RG
mF
JI
YZ
xx
UT
kc
cO
YZ
JI
JI
YZ
Yy
UT
UT
UB
YZ
JI
mF
RG
"}
(15,1,1) = {"
RG
mF
JI
YZ
BX
UT
UT
cO
YZ
JI
JI
YZ
cO
UB
cV
BX
YZ
JI
mF
RG
"}
(16,1,1) = {"
RG
mF
JI
YZ
BX
UT
UT
cO
oY
JI
JI
oY
cO
UT
UT
BX
YZ
JI
mF
RG
"}
(17,1,1) = {"
RG
mF
JI
YZ
YZ
YZ
YZ
YZ
YZ
JI
JI
YZ
YZ
YZ
YZ
YZ
YZ
JI
mF
RG
"}
(18,1,1) = {"
RG
mF
JI
JI
JI
JI
JI
JI
JI
JI
JI
JI
JI
JI
JI
JI
JI
JI
mF
RG
"}
(19,1,1) = {"
RG
mF
mF
mF
mF
mF
mF
mF
mF
mF
mF
mF
mF
mF
mF
mF
mF
mF
mF
RG
"}
(20,1,1) = {"
RG
RG
RG
RG
RG
RG
RG
RG
RG
mF
mF
RG
RG
RG
RG
RG
RG
RG
RG
RG
"}

(1,1,2) = {"
TQ
TQ
TQ
TQ
TQ
TQ
TQ
TQ
Qw
Qw
Qw
Qw
TQ
TQ
TQ
TQ
TQ
TQ
TQ
TQ
"}
(2,1,2) = {"
TQ
TQ
TQ
TQ
TQ
TQ
TQ
TQ
TQ
TQ
TQ
TQ
TQ
TQ
TQ
TQ
TQ
TQ
TQ
TQ
"}
(3,1,2) = {"
TQ
TQ
TQ
nu
nu
nu
nu
nu
nu
nu
nu
nu
nu
nu
nu
nu
nu
TQ
TQ
TQ
"}
(4,1,2) = {"
TQ
TQ
uR
Ey
Ey
Ey
Ey
Ey
Ey
Ey
Ey
Ey
Ey
Ey
Ey
Ey
Ey
Yr
TQ
TQ
"}
(5,1,2) = {"
TQ
TQ
uR
Ey
YP
pR
YP
Ey
dT
pQ
mx
EQ
Ey
KT
Vw
pR
Ey
Yr
TQ
TQ
"}
(6,1,2) = {"
TQ
TQ
uR
Ey
Ko
pR
YP
Ey
aO
PM
CU
CA
Ey
nx
pR
pR
Ey
Yr
TQ
TQ
"}
(7,1,2) = {"
TQ
TQ
uR
Ey
YP
pR
YP
Ey
FL
wQ
Qs
pR
Ey
pA
pR
pR
Ey
Yr
TQ
TQ
"}
(8,1,2) = {"
TQ
TQ
uR
Ey
pR
pR
pR
Ey
nn
pR
pR
pR
Ey
tJ
pR
pR
Ey
Yr
TQ
TQ
"}
(9,1,2) = {"
Qw
TQ
uR
Ey
Ey
rS
Ey
Ey
pR
pR
pR
pR
Ey
Ey
bO
Ey
Ey
Yr
TQ
Qw
"}
(10,1,2) = {"
Qw
TQ
uR
Zi
pR
pR
pR
pR
pR
TQ
dh
pR
pR
PQ
pR
pR
Zi
Yr
TQ
Qw
"}
(11,1,2) = {"
Qw
TQ
uR
Zi
pR
pR
pR
pR
pR
TQ
dh
pR
pR
hR
pR
pR
Zi
Yr
TQ
Qw
"}
(12,1,2) = {"
Qw
TQ
uR
Ey
Ey
Gb
Ey
Ey
pR
pR
pR
pR
Ey
Ey
Gb
Ey
Ey
Yr
TQ
Qw
"}
(13,1,2) = {"
TQ
TQ
uR
Ey
pR
pR
pR
Ey
nn
pR
pR
pR
Ey
pR
pR
pR
Ey
Yr
TQ
TQ
"}
(14,1,2) = {"
TQ
TQ
uR
Ey
pR
pR
pR
Ey
aY
pR
pR
pR
Ey
mh
pR
pR
Ey
Yr
TQ
TQ
"}
(15,1,2) = {"
TQ
TQ
uR
Ey
Ao
pR
pR
Ey
Ph
pR
pR
pR
Ey
Ao
pR
pR
Ey
Yr
TQ
TQ
"}
(16,1,2) = {"
TQ
TQ
uR
Ey
Fx
pR
pR
Ey
Gp
pR
pR
pR
Ey
Fx
pR
pR
Ey
Yr
TQ
TQ
"}
(17,1,2) = {"
TQ
TQ
uR
Ey
Ey
Ey
Ey
Ey
Ey
Ey
Ey
Ey
Ey
Ey
Ey
Ey
Ey
Yr
TQ
TQ
"}
(18,1,2) = {"
TQ
TQ
TQ
bv
bv
bv
bv
bv
bv
bv
bv
bv
bv
bv
bv
bv
bv
TQ
TQ
TQ
"}
(19,1,2) = {"
TQ
TQ
TQ
TQ
TQ
TQ
TQ
TQ
TQ
TQ
TQ
TQ
TQ
TQ
TQ
TQ
TQ
TQ
TQ
TQ
"}
(20,1,2) = {"
TQ
TQ
TQ
TQ
TQ
TQ
TQ
TQ
Qw
Qw
Qw
Qw
TQ
TQ
TQ
TQ
TQ
TQ
TQ
TQ
"}
