//MAP CONVERTED BY dmm2tgm.py THIS HEADER COMMENT PREVENTS RECONVERSION, DO NOT REMOVE
"a" = (
/turf/open/floor/rogue/naturalstone,
/area/rogue)
"b" = (
/obj/structure/table/wood/plain,
/turf/open/floor/rogue/herringbone,
/area/rogue)
"d" = (
/obj/structure/fermenting_barrel/random/beer,
/turf/open/floor/rogue/herringbone,
/area/rogue)
"e" = (
/obj/structure/fluff/statue/knightalt/r,
/turf/open/floor/rogue/hexstone,
/area/rogue)
"f" = (
/obj/machinery/light/rogue/hearth,
/obj/item/cooking/pan,
/turf/open/floor/rogue/herringbone,
/area/rogue)
"g" = (
/obj/structure/fluff/traveltile,
/turf/open/floor/rogue/herringbone,
/area/rogue)
"h" = (
/obj/structure/mineral_door/wood,
/turf/open/floor/rogue/hexstone,
/area/rogue)
"i" = (
/obj/structure/closet/crate/roguecloset/inn,
/obj/item/clothing/suit/roguetown/shirt/robe/plain,
/turf/open/floor/rogue/herringbone,
/area/rogue)
"j" = (
/obj/structure/closet/crate/chest,
/obj/item/reagent_containers/food/snacks/produce/wheat,
/obj/item/reagent_containers/food/snacks/produce/wheat,
/obj/item/reagent_containers/food/snacks/produce/wheat,
/obj/item/reagent_containers/food/snacks/produce/wheat,
/obj/item/reagent_containers/food/snacks/produce/wheat,
/obj/item/reagent_containers/food/snacks/produce/wheat,
/obj/item/reagent_containers/food/snacks/produce/wheat,
/obj/item/reagent_containers/food/snacks/produce/wheat,
/obj/item/reagent_containers/food/snacks/produce/wheat,
/turf/open/floor/rogue/herringbone,
/area/rogue)
"k" = (
/obj/machinery/light/rogue/firebowl,
/turf/open/floor/rogue/dirt,
/area/rogue)
"l" = (
/obj/structure/table/church,
/obj/item/flashlight/flare/torch/metal{
	pixel_y = 7
	},
/obj/item/flashlight/flare/torch/metal{
	pixel_y = 6;
	pixel_x = -8
	},
/obj/item/flashlight/flare/torch/metal{
	pixel_x = 7;
	pixel_y = 6
	},
/turf/open/floor/rogue/hexstone,
/area/rogue)
"m" = (
/obj/structure/table/wood/plain,
/obj/item/rogueweapon/knife/cleaver,
/turf/open/floor/rogue/herringbone,
/area/rogue)
"n" = (
/obj/structure/fluff/statue/knight/interior,
/turf/open/floor/rogue/hexstone,
/area/rogue)
"o" = (
/obj/machinery/light/rogue/torchholder/c,
/turf/open/floor/rogue/herringbone,
/area/rogue)
"p" = (
/obj/structure/table/church{
	dir = 1
	},
/obj/item/reagent_containers/food/snacks/rogue/crackerscooked{
	pixel_x = 8;
	pixel_y = 12
	},
/obj/item/reagent_containers/food/snacks/rogue/crackerscooked{
	pixel_x = 2;
	pixel_y = 4
	},
/obj/item/reagent_containers/food/snacks/rogue/crackerscooked{
	pixel_x = -7;
	pixel_y = 11
	},
/turf/open/floor/rogue/hexstone,
/area/rogue)
"q" = (
/obj/effect/decal/cleanable/sigil/E,
/turf/open/floor/rogue/hexstone,
/area/rogue)
"r" = (
/obj/structure/closet/crate/chest,
/obj/item/neuFarm/seed/wheat,
/obj/item/neuFarm/seed/wheat,
/obj/item/neuFarm/seed/wheat,
/obj/item/neuFarm/seed/wheat,
/obj/item/neuFarm/seed/wheat,
/obj/item/neuFarm/seed/wheat,
/obj/item/neuFarm/seed/wheat,
/obj/item/rogueweapon/hoe,
/obj/item/rogueweapon/sickle,
/obj/item/rogueweapon/thresher,
/obj/item/neuFarm/seed/onion,
/obj/item/neuFarm/seed/onion,
/obj/item/neuFarm/seed/onion,
/obj/item/neuFarm/seed/onion,
/obj/item/neuFarm/seed/onion,
/obj/item/neuFarm/seed/onion,
/obj/item/neuFarm/seed/cabbage,
/obj/item/neuFarm/seed/cabbage,
/obj/item/neuFarm/seed/cabbage,
/obj/item/neuFarm/seed/cabbage,
/obj/item/neuFarm/seed/apple,
/obj/item/neuFarm/seed/apple,
/obj/item/neuFarm/seed/apple,
/turf/open/floor/rogue/dirt,
/area/rogue)
"s" = (
/obj/structure/fluff/statue/evil,
/turf/open/floor/rogue/hexstone,
/area/rogue)
"t" = (
/obj/effect/decal/cleanable/sigil/S,
/turf/open/floor/rogue/hexstone,
/area/rogue)
"u" = (
/obj/structure/stairs/stone/church{
	dir = 1
	},
/turf/open/transparent/openspace,
/area/rogue)
"v" = (
/obj/structure/closet/crate/drawer/inn,
/turf/open/floor/rogue/herringbone,
/area/rogue)
"w" = (
/obj/item/reagent_containers/glass/bucket/wooden/alter,
/turf/open/floor/rogue/dirt,
/area/rogue)
"x" = (
/obj/effect/decal/cleanable/sigil/W,
/turf/open/floor/rogue/hexstone,
/area/rogue)
"y" = (
/turf/open/transparent/openspace,
/area/rogue)
"z" = (
/obj/structure/table/wood/plain,
/obj/structure/fluff/millstone,
/turf/open/floor/rogue/herringbone,
/area/rogue)
"A" = (
/obj/structure/fluff/statue/knightalt,
/turf/open/floor/rogue/hexstone,
/area/rogue)
"B" = (
/turf/open/floor/rogue/dirt,
/area/rogue)
"C" = (
/obj/structure/fermenting_barrel/random/water,
/turf/open/floor/rogue/herringbone,
/area/rogue)
"D" = (
/obj/structure/roguewindow/openclose,
/turf/closed/wall/mineral/rogue/stone/window,
/area/rogue)
"E" = (
/turf/closed/mineral/rogue/bedrock,
/area/rogue)
"F" = (
/obj/machinery/light/rogue/firebowl,
/turf/open/floor/rogue/hexstone,
/area/rogue)
"G" = (
/obj/structure/closet/crate/chest/crafted,
/turf/open/floor/rogue/hexstone,
/area/rogue)
"H" = (
/obj/effect/decal/cleanable/sigil/SE,
/turf/open/floor/rogue/hexstone,
/area/rogue)
"I" = (
/obj/effect/decal/cleanable/sigil,
/obj/effect/decal/cleanable/blood,
/turf/open/floor/rogue/hexstone,
/area/rogue)
"J" = (
/obj/structure/table/church/m,
/obj/item/reagent_containers/glass/bottle/waterskin{
	pixel_y = -1;
	pixel_x = -5
	},
/obj/item/reagent_containers/glass/bottle/waterskin{
	pixel_y = 3
	},
/obj/item/reagent_containers/glass/bottle/waterskin{
	pixel_x = 8;
	pixel_y = 7
	},
/turf/open/floor/rogue/hexstone,
/area/rogue)
"K" = (
/obj/structure/well,
/turf/open/floor/rogue/dirt,
/area/rogue)
"L" = (
/obj/structure/bed/rogue/inn,
/obj/machinery/light/rogue/torchholder/c,
/turf/open/floor/rogue/herringbone,
/area/rogue)
"M" = (
/obj/machinery/light/rogue/oven/east,
/turf/open/floor/rogue/herringbone,
/area/rogue)
"N" = (
/obj/structure/mineral_door/wood,
/turf/closed/wall/mineral/rogue/stone/window,
/area/rogue)
"O" = (
/obj/effect/decal/cleanable/sigil/SW,
/turf/open/floor/rogue/hexstone,
/area/rogue)
"P" = (
/turf/closed/wall/mineral/rogue/stone/window,
/area/rogue)
"Q" = (
/obj/machinery/light/rogue/firebowl,
/turf/open/floor/rogue/naturalstone,
/area/rogue)
"R" = (
/obj/structure/stairs/stone/church{
	dir = 1
	},
/turf/open/floor/rogue/hexstone,
/area/rogue)
"S" = (
/obj/machinery/light/rogue/hearth,
/obj/item/reagent_containers/glass/bucket/pot,
/turf/open/floor/rogue/herringbone,
/area/rogue)
"T" = (
/turf/open/floor/rogue/herringbone,
/area/rogue)
"U" = (
/obj/structure/gate/preopen,
/turf/open/floor/rogue/hexstone,
/area/rogue)
"V" = (
/turf/open/floor/carpet/red,
/area/rogue)
"W" = (
/turf/open/floor/rogue/hexstone,
/area/rogue)
"X" = (
/obj/machinery/light/rogue/torchholder/l,
/turf/open/floor/rogue/hexstone,
/area/rogue)
"Y" = (
/obj/structure/fluff/statue/knight/interior/r,
/turf/open/floor/rogue/hexstone,
/area/rogue)
"Z" = (
/turf/closed/wall/mineral/rogue/stone,
/area/rogue)

(1,1,1) = {"
E
E
E
E
E
E
E
E
a
a
a
a
a
a
a
a
a
a
a
a
a
a
a
a
a
a
E
E
E
E
E
E
E
E
E
"}
(2,1,1) = {"
E
a
a
a
a
E
E
E
a
a
a
a
a
a
a
a
a
a
a
a
a
a
a
a
a
a
a
E
E
E
E
E
E
E
E
"}
(3,1,1) = {"
E
a
a
a
E
E
a
a
a
a
a
a
a
a
a
a
a
a
a
a
a
a
a
a
a
a
a
a
E
E
E
E
E
E
E
"}
(4,1,1) = {"
E
E
a
E
E
a
a
a
a
B
B
B
a
a
a
B
a
a
a
a
B
a
B
a
B
k
B
a
a
E
E
E
E
E
a
"}
(5,1,1) = {"
E
E
a
a
a
a
a
a
B
B
B
B
B
a
B
B
B
a
a
B
B
B
B
B
B
B
B
a
a
a
E
E
E
a
a
"}
(6,1,1) = {"
E
E
E
a
a
a
a
a
B
B
B
B
B
B
B
B
B
B
B
Z
Z
Z
Z
Z
B
B
B
B
a
a
a
a
a
a
a
"}
(7,1,1) = {"
a
a
a
a
a
a
a
a
B
B
B
Z
Z
Z
Z
Z
B
B
B
Z
R
W
X
Z
r
B
B
B
B
a
a
a
a
a
a
"}
(8,1,1) = {"
a
a
a
a
a
a
a
a
B
B
B
Z
F
W
W
Z
Z
Z
Z
Z
R
W
W
Z
w
B
B
B
B
a
a
a
a
a
a
"}
(9,1,1) = {"
a
a
a
a
a
a
a
B
B
B
B
Z
W
W
W
n
F
n
W
Z
Z
Z
h
Z
B
B
B
B
B
a
a
a
a
a
a
"}
(10,1,1) = {"
a
a
a
a
a
a
a
B
B
B
B
Z
G
W
W
W
W
W
W
W
W
W
W
Z
B
B
B
B
B
a
a
a
a
a
a
"}
(11,1,1) = {"
a
a
a
a
a
a
a
B
B
B
B
Z
A
W
l
x
O
W
W
V
V
V
V
U
W
W
W
W
B
a
a
a
a
a
a
"}
(12,1,1) = {"
a
a
a
a
a
a
a
B
B
B
B
Z
s
W
J
I
t
W
W
V
V
V
V
W
W
W
K
W
B
a
a
a
a
a
a
"}
(13,1,1) = {"
a
a
a
a
a
a
a
B
B
B
B
Z
e
W
p
q
H
W
W
V
V
V
V
W
W
W
W
W
B
a
a
a
a
a
E
"}
(14,1,1) = {"
a
a
a
a
a
a
a
B
B
B
B
Z
W
W
W
W
W
W
W
W
W
W
W
Z
B
B
B
B
B
a
a
a
a
E
E
"}
(15,1,1) = {"
E
E
E
E
a
a
a
B
B
B
B
Z
W
W
W
Y
F
Y
W
W
W
W
W
Z
B
B
B
B
B
a
a
a
E
E
E
"}
(16,1,1) = {"
E
E
E
E
a
a
a
B
B
B
B
Z
F
W
W
Z
Z
Z
Z
Z
W
W
W
Z
B
B
B
B
B
a
a
a
E
E
E
"}
(17,1,1) = {"
E
E
E
E
E
a
a
a
B
B
B
Z
Z
Z
Z
Z
B
B
B
Z
W
W
F
Z
B
B
B
B
a
a
a
a
E
E
E
"}
(18,1,1) = {"
E
E
E
E
E
E
a
a
B
B
B
B
B
B
B
B
B
a
B
Z
Z
Z
Z
Z
B
B
B
B
a
a
E
a
a
E
E
"}
(19,1,1) = {"
E
E
E
E
E
E
a
a
B
B
B
B
B
B
B
B
B
a
a
B
B
B
B
B
B
B
B
a
a
a
E
E
a
E
E
"}
(20,1,1) = {"
E
E
E
E
E
E
a
a
a
B
a
a
B
B
B
B
a
a
B
B
B
a
B
B
B
B
a
a
a
a
a
E
E
E
E
"}
(21,1,1) = {"
E
E
E
E
E
E
E
a
a
a
a
a
a
a
a
a
a
a
a
a
a
a
a
Q
a
a
a
a
E
E
a
E
E
E
E
"}
(22,1,1) = {"
E
E
E
E
E
E
E
a
a
a
a
a
a
a
a
a
a
a
a
a
a
a
a
a
a
a
a
E
E
E
E
a
E
E
E
"}
(23,1,1) = {"
E
E
E
E
E
E
E
E
a
a
a
a
a
a
a
a
a
a
a
a
a
E
a
a
a
a
a
a
E
E
E
a
a
E
E
"}
(24,1,1) = {"
E
E
E
E
E
E
E
E
E
E
E
E
E
E
a
a
a
a
E
a
E
E
E
E
a
E
a
a
E
E
E
E
E
E
E
"}
(25,1,1) = {"
E
E
E
E
E
E
E
E
E
E
E
E
E
E
E
E
a
E
E
E
E
E
E
E
E
E
E
E
E
E
E
E
E
E
E
"}

(1,1,2) = {"
y
y
y
y
y
y
y
y
y
y
y
y
y
y
y
y
y
y
y
y
y
y
y
y
y
y
y
y
y
y
y
y
y
y
y
"}
(2,1,2) = {"
y
y
y
y
y
y
y
y
y
y
y
y
y
y
y
y
y
y
y
y
y
y
y
y
y
y
y
y
y
y
y
y
y
y
y
"}
(3,1,2) = {"
y
y
y
y
y
y
y
y
y
y
y
y
y
y
y
y
y
y
y
y
y
y
y
y
y
y
y
y
y
y
y
y
y
y
y
"}
(4,1,2) = {"
y
y
y
y
y
y
y
y
y
y
y
y
y
y
y
y
y
y
y
y
y
y
y
y
y
y
y
y
y
y
y
y
y
y
y
"}
(5,1,2) = {"
y
y
y
y
y
y
y
y
y
y
y
y
y
y
y
y
y
y
y
y
y
y
y
y
y
y
y
y
y
y
y
y
y
y
y
"}
(6,1,2) = {"
y
y
y
y
y
y
y
y
y
y
y
P
P
P
D
P
P
P
P
P
P
P
P
P
y
y
y
y
y
y
y
y
y
y
y
"}
(7,1,2) = {"
y
y
y
y
y
y
y
y
y
y
y
P
i
T
T
T
P
o
T
u
y
d
C
P
y
y
y
y
y
y
y
y
y
y
y
"}
(8,1,2) = {"
y
y
y
y
y
y
y
y
y
y
y
D
v
T
T
T
P
T
T
u
y
T
T
P
y
y
y
y
y
y
y
y
y
y
y
"}
(9,1,2) = {"
y
y
y
y
y
y
y
y
y
y
y
P
L
T
T
T
N
T
T
T
T
T
T
P
y
y
y
y
y
y
y
y
y
y
y
"}
(10,1,2) = {"
y
y
y
y
y
y
y
y
y
y
y
P
P
P
P
P
P
N
P
P
P
P
P
P
y
y
y
y
y
y
y
y
y
y
y
"}
(11,1,2) = {"
y
y
y
y
y
y
y
y
y
y
y
P
i
T
T
T
P
o
T
T
M
S
f
P
y
y
y
y
y
y
y
y
y
y
y
"}
(12,1,2) = {"
y
y
y
y
y
y
y
y
y
y
y
D
v
T
T
T
N
T
T
T
T
T
T
D
y
y
y
y
y
y
y
y
y
y
y
"}
(13,1,2) = {"
y
y
y
y
y
y
y
y
y
y
y
P
L
T
T
T
P
o
T
j
z
b
m
P
y
y
y
y
y
y
y
y
y
y
y
"}
(14,1,2) = {"
y
y
y
y
y
y
y
y
y
y
y
P
P
P
P
P
P
N
P
P
P
P
P
P
y
y
y
y
y
y
y
y
y
y
y
"}
(15,1,2) = {"
y
y
y
y
y
y
y
y
y
y
y
P
i
T
T
T
N
T
T
T
T
g
g
P
y
y
y
y
y
y
y
y
y
y
y
"}
(16,1,2) = {"
y
y
y
y
y
y
y
y
y
y
y
D
v
T
T
T
P
T
T
T
T
g
g
P
y
y
y
y
y
y
y
y
y
y
y
"}
(17,1,2) = {"
y
y
y
y
y
y
y
y
y
y
y
P
L
T
T
T
P
o
T
T
T
g
g
P
y
y
y
y
y
y
y
y
y
y
y
"}
(18,1,2) = {"
y
y
y
y
y
y
y
y
y
y
y
P
P
P
D
P
P
P
P
P
P
P
P
P
y
y
y
y
y
y
y
y
y
y
y
"}
(19,1,2) = {"
y
y
y
y
y
y
y
y
y
y
y
y
y
y
y
y
y
y
y
y
y
y
y
y
y
y
y
y
y
y
y
y
y
y
y
"}
(20,1,2) = {"
y
y
y
y
y
y
y
y
y
y
y
y
y
y
y
y
y
y
y
y
y
y
y
y
y
y
y
y
y
y
y
y
y
y
y
"}
(21,1,2) = {"
y
y
y
y
y
y
y
y
y
y
y
y
y
y
y
y
y
y
y
y
y
y
y
y
y
y
y
y
y
y
y
y
y
y
y
"}
(22,1,2) = {"
y
y
y
y
y
y
y
y
y
y
y
y
y
y
y
y
y
y
y
y
y
y
y
y
y
y
y
y
y
y
y
y
y
y
y
"}
(23,1,2) = {"
y
y
y
y
y
y
y
y
y
y
y
y
y
y
y
y
y
y
y
y
y
y
y
y
y
y
y
y
y
y
y
y
y
y
y
"}
(24,1,2) = {"
y
y
y
y
y
y
y
y
y
y
y
y
y
y
y
y
y
y
y
y
y
y
y
y
y
y
y
y
y
y
y
y
y
y
y
"}
(25,1,2) = {"
y
y
y
y
y
y
y
y
y
y
y
y
y
y
y
y
y
y
y
y
y
y
y
y
y
y
y
y
y
y
y
y
y
y
y
"}
