//MAP CONVERTED BY dmm2tgm.py THIS HEADER COMMENT PREVENTS RECONVERSION, DO NOT REMOVE
"aK" = (
/obj/structure/table/wood/bar,
/obj/structure/fluff/railing/border{
	icon_state = "border";
	dir = 5
	},
/turf/open/floor/rogue/ruinedwood/darker,
/area/rogue)
"aT" = (
/obj/structure/roguewindow/stained,
/turf/closed/wall/mineral/rogue/stonebrick,
/area/rogue)
"be" = (
/obj/structure/stairs/stone,
/obj/structure/stairs/stone,
/turf/open/floor/rogue/hexstone,
/area/rogue)
"ce" = (
/obj/structure/chair/bench/couchablack,
/mob/living/carbon/human/species/skeleton/npc/ambush,
/turf/open/floor/rogue/ruinedwood/darker,
/area/rogue)
"cg" = (
/obj/structure/fluff/railing/border{
	icon_state = "border";
	dir = 4
	},
/turf/open/floor/rogue/ruinedwood/darker,
/area/rogue)
"cp" = (
/obj/structure/table/wood/counter/end{
	dir = 8
	},
/turf/open/floor/rogue/hexstone,
/area/rogue)
"cA" = (
/obj/item/clothing/gloves/roguetown/chain/iron,
/turf/open/floor/rogue/hexstone,
/area/rogue)
"cR" = (
/mob/living/carbon/human/species/goblin/npc/ambush/sea,
/turf/open/floor/rogue/hexstone,
/area/rogue)
"eD" = (
/obj/item/clothing/shoes/roguetown/boots/armor,
/obj/structure/fluff/walldeco/chains,
/turf/open/floor/rogue/hexstone,
/area/rogue)
"fd" = (
/obj/structure/fluff/walldeco/bsmith,
/turf/open/floor/rogue/hexstone,
/area/rogue)
"gI" = (
/obj/structure/fluff/railing/border{
	icon_state = "border";
	dir = 1
	},
/turf/open/floor/rogue/ruinedwood/darker,
/area/rogue)
"gO" = (
/obj/machinery/light/rogue/torchholder/l,
/turf/open/floor/rogue/hexstone,
/area/rogue)
"hj" = (
/obj/structure/table/wood/counter{
	dir = 1
	},
/obj/item/reagent_containers/food/snacks/rogue/bun_grenz/plated{
	pixel_x = 12;
	pixel_y = 11
	},
/turf/open/floor/rogue/hexstone,
/area/rogue)
"hQ" = (
/obj/structure/fluff/railing/border{
	dir = 9;
	icon_state = "border"
	},
/turf/open/floor/rogue/ruinedwood/darker,
/area/rogue)
"hX" = (
/turf/closed/wall/mineral/rogue/stonebrick,
/area/rogue)
"if" = (
/mob/living/simple_animal/hostile/rogue/skeleton/guard,
/turf/open/floor/rogue/ruinedwood/darker,
/area/rogue)
"iE" = (
/obj/structure/fermenting_barrel/random/water,
/turf/open/floor/rogue/ruinedwood/darker,
/area/rogue)
"iH" = (
/obj/structure/fluff/railing/border{
	icon_state = "border";
	dir = 8
	},
/turf/open/floor/rogue/ruinedwood/darker,
/area/rogue)
"jd" = (
/obj/effect/decal/cleanable/blood/gibs/limb,
/turf/open/floor/rogue/hexstone,
/area/rogue)
"jw" = (
/obj/item/rogueweapon/knife/dagger/steel,
/turf/open/floor/rogue/hexstone,
/area/rogue)
"jD" = (
/obj/machinery/light/rogue/torchholder/l,
/mob/living/carbon/human/species/skeleton/npc/warrior,
/turf/open/floor/rogue/hexstone,
/area/rogue)
"ka" = (
/obj/structure/chair/bench/church/mid,
/obj/structure/chair/bench/church/mid,
/turf/open/floor/rogue/ruinedwood/darker,
/area/rogue)
"kU" = (
/obj/structure/mineral_door/wood/donjon{
	dir = 4
	},
/obj/structure/mineral_door/wood/donjon{
	dir = 8;
	locked = 1
	},
/turf/closed/wall/mineral/rogue/stonebrick,
/area/rogue)
"ld" = (
/obj/structure/rack/rogue/shelf/biggest,
/obj/item/rogueweapon/polearm/spear/billhook,
/obj/item/rogueweapon/polearm/spear/billhook{
	pixel_y = -8
	},
/turf/open/floor/rogue/hexstone,
/area/rogue)
"mo" = (
/obj/structure/fluff/railing/border{
	icon_state = "border";
	dir = 1
	},
/obj/structure/chair/bench/church{
	dir = 1
	},
/mob/living/carbon/human/species/skeleton/no_equipment,
/turf/open/floor/rogue/ruinedwood/darker,
/area/rogue)
"mH" = (
/obj/structure/table/wood/counter/end,
/obj/item/reagent_containers/food/snacks/rogue/bun_grenz/plated,
/turf/open/floor/rogue/hexstone,
/area/rogue)
"mL" = (
/obj/structure/mineral_door/wood/donjon{
	dir = 8;
	locked = 1
	},
/turf/open/floor/rogue/ruinedwood/darker,
/area/rogue)
"mX" = (
/turf/closed/wall/mineral/rogue/stone/window/moss,
/area/rogue)
"oY" = (
/obj/item/ingot/iron,
/obj/item/ingot/iron{
	pixel_y = -2;
	pixel_x = 12
	},
/obj/item/ingot/iron{
	pixel_y = 5;
	pixel_x = 7
	},
/turf/open/floor/rogue/hexstone,
/area/rogue)
"pA" = (
/obj/structure/fluff/railing/border{
	icon_state = "border";
	dir = 5
	},
/turf/open/floor/rogue/ruinedwood/darker,
/area/rogue)
"pT" = (
/turf/open/floor/rogue/hexstone,
/area/rogue)
"qk" = (
/obj/structure/table/wood/counter/end{
	dir = 1
	},
/turf/open/floor/rogue/hexstone,
/area/rogue)
"qD" = (
/obj/structure/table/wood/counter{
	dir = 1
	},
/obj/item/reagent_containers/food/snacks/rogue/bun_grenz/plated{
	pixel_y = 5;
	pixel_x = -7
	},
/turf/open/floor/rogue/hexstone,
/area/rogue)
"qQ" = (
/mob/living/carbon/human/species/goblin/npc/hell{
	name = "Bobby Baker"
	},
/turf/open/floor/rogue/hexstone,
/area/rogue)
"qY" = (
/obj/structure/fluff/railing/border{
	icon_state = "border";
	dir = 1
	},
/obj/structure/chair/bench/church/r,
/turf/open/floor/rogue/ruinedwood/darker,
/area/rogue)
"rH" = (
/mob/living/carbon/human/species/goblin/npc/hell{
	name = "Weinerman"
	},
/turf/open/floor/rogue/hexstone,
/area/rogue)
"rW" = (
/obj/structure/table/wood/counter{
	dir = 1
	},
/turf/open/floor/rogue/hexstone,
/area/rogue)
"ss" = (
/obj/structure/stairs/stone,
/turf/open/floor/rogue/hexstone,
/area/rogue)
"sM" = (
/obj/item/rogueweapon/sword/arming,
/turf/open/floor/rogue/hexstone,
/area/rogue)
"tz" = (
/obj/structure/chair/bench/church/smallbench{
	dir = 4
	},
/obj/structure/fluff/railing/border,
/turf/open/floor/rogue/ruinedwood/darker,
/area/rogue)
"tY" = (
/obj/item/natural/stone{
	pixel_y = 5
	},
/mob/living/carbon/human/species/orc/ambush{
	name = "Slambo"
	},
/turf/open/floor/rogue/hexstone,
/area/rogue)
"uC" = (
/obj/structure/table/wood/counter{
	dir = 1
	},
/obj/structure/table/wood/counter{
	dir = 1
	},
/obj/item/reagent_containers/food/snacks/rogue/bun_grenz/plated,
/turf/open/floor/rogue/hexstone,
/area/rogue)
"uU" = (
/obj/effect/decal/cleanable/blood/splatter,
/turf/open/floor/rogue/hexstone,
/area/rogue)
"vT" = (
/obj/structure/chair/bench/church/smallbench{
	dir = 4
	},
/turf/open/floor/rogue/ruinedwood/darker,
/area/rogue)
"wq" = (
/obj/structure/fluff/railing/border,
/obj/structure/table/vtable,
/obj/item/reagent_containers/glass/cup/golden{
	pixel_y = 8;
	pixel_x = -5
	},
/obj/item/reagent_containers/glass/bottle/rogue/redwine{
	pixel_y = 12;
	pixel_x = 7
	},
/turf/open/floor/rogue/ruinedwood/darker,
/area/rogue)
"xB" = (
/obj/structure/fluff/railing/border{
	icon_state = "border";
	dir = 1
	},
/obj/structure/chair/bench/church/mid,
/mob/living/carbon/human/species/skeleton/no_equipment,
/turf/open/floor/rogue/ruinedwood/darker,
/area/rogue)
"xO" = (
/obj/structure/mineral_door/wood/donjon{
	dir = 8;
	locked = 1
	},
/turf/closed/wall/mineral/rogue/stonebrick,
/area/rogue)
"xX" = (
/turf/open/transparent/openspace,
/area/rogue)
"yW" = (
/obj/structure/chair/bench/church/mid,
/turf/open/floor/rogue/ruinedwood/darker,
/area/rogue)
"zL" = (
/mob/living/carbon/human/species/goblin/npc{
	name = "The Bartender"
	},
/turf/open/floor/rogue/ruinedwood/darker,
/area/rogue)
"zX" = (
/obj/structure/rack/rogue/shelf/biggest,
/obj/item/gun/ballistic/revolver/grenadelauncher/bow/long,
/obj/item/ammo_holder/quiver/arrows,
/turf/open/floor/rogue/ruinedwood/darker,
/area/rogue)
"Bu" = (
/obj/machinery/light/rogue/torchholder/r,
/turf/open/floor/rogue/hexstone,
/area/rogue)
"BS" = (
/obj/effect/decal/cleanable/blood/gibs,
/turf/open/floor/rogue/hexstone,
/area/rogue)
"Ci" = (
/obj/structure/mineral_door/wood{
	locked = 1
	},
/turf/open/floor/rogue/hexstone,
/area/rogue)
"Cr" = (
/obj/structure/fluff/railing/border{
	icon_state = "border";
	dir = 1
	},
/obj/structure/chair/bench/church/mid,
/obj/item/clothing/head/peaceflower,
/turf/open/floor/rogue/ruinedwood/darker,
/area/rogue)
"CJ" = (
/obj/item/clothing/suit/roguetown/armor/chainmail/iron,
/turf/open/floor/rogue/hexstone,
/area/rogue)
"CK" = (
/mob/living/carbon/human/species/skeleton/npc/warrior,
/turf/open/floor/rogue/hexstone,
/area/rogue)
"DJ" = (
/turf/closed/mineral/rogue/bedrock,
/area/rogue)
"EG" = (
/obj/structure/chair/bench/couchablack/r,
/mob/living/carbon/human/species/skeleton/npc/warrior/skilled{
	name = "Lord of the Pit"
	},
/turf/open/floor/rogue/ruinedwood/darker,
/area/rogue)
"EH" = (
/obj/structure/table/wood/bar,
/obj/item/reagent_containers/glass/cup/skull,
/turf/open/floor/rogue/ruinedwood/darker,
/area/rogue)
"GL" = (
/obj/machinery/light/rogue/forge,
/obj/item/rogueweapon/tongs,
/turf/open/floor/rogue/hexstone,
/area/rogue)
"HQ" = (
/obj/structure/chair/bench/church/smallbench{
	dir = 4
	},
/mob/living/carbon/human/species/skeleton/no_equipment,
/obj/structure/fluff/railing/border{
	dir = 10;
	icon_state = "border"
	},
/turf/open/floor/rogue/ruinedwood/darker,
/area/rogue)
"Iz" = (
/mob/living/carbon/human/species/orc/warrior,
/turf/open/floor/rogue/hexstone,
/area/rogue)
"Jk" = (
/obj/structure/fluff/railing/border,
/turf/open/floor/rogue/ruinedwood/darker,
/area/rogue)
"Ky" = (
/obj/item/natural/stone,
/obj/item/natural/stone,
/obj/item/natural/stone,
/obj/item/natural/stone{
	pixel_y = 10;
	pixel_x = 10
	},
/obj/machinery/anvil,
/obj/item/rogueweapon/hammer/iron,
/turf/open/floor/rogue/hexstone,
/area/rogue)
"Ll" = (
/obj/structure/bars,
/turf/open/floor/rogue/hexstone,
/area/rogue)
"LG" = (
/obj/structure/fluff/grindwheel,
/turf/open/floor/rogue/hexstone,
/area/rogue)
"My" = (
/obj/structure/fluff/railing/border,
/obj/structure/table/vtable/v2,
/obj/item/reagent_containers/glass/cup/golden{
	pixel_y = 8;
	pixel_x = 8
	},
/obj/item/rogueweapon/sword/decorated{
	pixel_x = -5;
	pixel_y = 8
	},
/obj/item/roguegem,
/obj/item/roguegem{
	pixel_x = -11;
	pixel_y = 11
	},
/turf/open/floor/rogue/ruinedwood/darker,
/area/rogue)
"MW" = (
/obj/item/rogueore/coal,
/turf/open/floor/rogue/hexstone,
/area/rogue)
"Nd" = (
/obj/structure/chair/bench/church/r,
/mob/living/carbon/human/species/skeleton/no_equipment,
/turf/open/floor/rogue/ruinedwood/darker,
/area/rogue)
"Oo" = (
/obj/structure/fluff/railing/border{
	dir = 10;
	icon_state = "border"
	},
/turf/open/floor/rogue/ruinedwood/darker,
/area/rogue)
"Ot" = (
/obj/structure/chair/bench/church/smallbench{
	dir = 4
	},
/mob/living/carbon/human/species/skeleton/no_equipment,
/turf/open/floor/rogue/ruinedwood/darker,
/area/rogue)
"Pq" = (
/obj/effect/decal/cleanable/blood/gibs/up,
/turf/open/floor/rogue/hexstone,
/area/rogue)
"PG" = (
/obj/structure/fermenting_barrel/random/beer,
/turf/open/floor/rogue/ruinedwood/darker,
/area/rogue)
"PH" = (
/obj/effect/decal/cleanable/blood/footprints,
/turf/open/floor/rogue/hexstone,
/area/rogue)
"PT" = (
/obj/structure/fluff/walldeco/stone,
/turf/closed/wall/mineral/rogue/stone/window/moss,
/area/rogue)
"Qa" = (
/obj/structure/fluff/railing/border{
	icon_state = "border";
	dir = 6
	},
/turf/open/floor/rogue/ruinedwood/darker,
/area/rogue)
"Qp" = (
/obj/structure/chair/bench/church/r,
/turf/open/floor/rogue/ruinedwood/darker,
/area/rogue)
"Sd" = (
/obj/effect/decal/cleanable/blood/tracks,
/turf/open/floor/rogue/hexstone,
/area/rogue)
"SV" = (
/obj/item/restraints/legcuffs/beartrap/armed/camouflage,
/turf/open/floor/rogue/hexstone,
/area/rogue)
"TM" = (
/obj/structure/table/wood/bar,
/turf/open/floor/rogue/ruinedwood/darker,
/area/rogue)
"TT" = (
/obj/structure/chair/bench/church/mid,
/mob/living/carbon/human/species/skeleton/no_equipment,
/turf/open/floor/rogue/ruinedwood/darker,
/area/rogue)
"Ub" = (
/obj/structure/chair/bench/church/smallbench{
	dir = 4
	},
/obj/item/clothing/head/peaceflower,
/turf/open/floor/rogue/ruinedwood/darker,
/area/rogue)
"UI" = (
/turf/open/floor/rogue/ruinedwood/darker,
/area/rogue)
"UM" = (
/obj/structure/stairs/stone{
	dir = 1
	},
/turf/open/floor/rogue/hexstone,
/area/rogue)
"UV" = (
/obj/structure/rack/rogue/shelf/big,
/turf/open/floor/rogue/hexstone,
/area/rogue)
"Vl" = (
/obj/structure/table/wood/counter{
	dir = 1
	},
/obj/item/reagent_containers/food/snacks/rogue/biscuit_poison,
/obj/item/reagent_containers/food/snacks/rogue/biscuit,
/obj/item/reagent_containers/food/snacks/rogue/biscuit{
	pixel_x = 12
	},
/obj/item/reagent_containers/food/snacks/rogue/biscuit{
	pixel_y = 5;
	pixel_x = 8
	},
/obj/item/reagent_containers/food/snacks/rogue/biscuit{
	pixel_y = 12;
	pixel_x = 9
	},
/turf/open/floor/rogue/hexstone,
/area/rogue)
"Vr" = (
/obj/structure/table/wood/counter{
	dir = 8
	},
/obj/structure/rack/rogue/shelf/big,
/obj/item/reagent_containers/glass/cup/silver{
	pixel_x = 6;
	pixel_y = 19
	},
/obj/item/reagent_containers/glass/cup/silver{
	pixel_y = 21;
	pixel_x = -6
	},
/turf/open/floor/rogue/ruinedwood/darker,
/area/rogue)
"We" = (
/obj/item/rogueweapon/polearm/spear,
/obj/effect/decal/cleanable/blood,
/turf/open/floor/rogue/hexstone,
/area/rogue)
"Wr" = (
/obj/structure/table/wood/counter{
	dir = 1
	},
/obj/item/reagent_containers/food/snacks/rogue/cheddarwedge/aged,
/turf/open/floor/rogue/hexstone,
/area/rogue)
"Xa" = (
/obj/structure/rack/rogue/shelf/biggest,
/obj/item/reagent_containers/glass/bottle/rogue/strongpoison,
/turf/open/floor/rogue/ruinedwood/darker,
/area/rogue)
"Xx" = (
/obj/structure/mineral_door/wood/donjon{
	dir = 4;
	locked = 1
	},
/turf/open/floor/rogue/ruinedwood/darker,
/area/rogue)
"XA" = (
/turf/closed,
/area/rogue)
"Za" = (
/mob/living/carbon/human/species/zizombie/npc/ambush,
/obj/item/natural/poo,
/obj/effect/decal/cleanable/blood/splatter,
/turf/open/floor/rogue/hexstone,
/area/rogue)
"Zh" = (
/obj/effect/decal/cleanable/blood/gibs/core,
/turf/open/floor/rogue/hexstone,
/area/rogue)
"ZD" = (
/obj/structure/bed/rogue/shit,
/turf/open/floor/rogue/hexstone,
/area/rogue)
"ZW" = (
/obj/structure/chair/bench/church{
	dir = 1
	},
/turf/open/floor/rogue/ruinedwood/darker,
/area/rogue)
"ZY" = (
/obj/structure/table/wood/counter,
/turf/open/floor/rogue/hexstone,
/area/rogue)

(1,1,1) = {"
DJ
DJ
DJ
DJ
DJ
DJ
DJ
pT
pT
pT
pT
pT
DJ
DJ
DJ
DJ
DJ
DJ
DJ
DJ
"}
(2,1,1) = {"
DJ
pT
pT
pT
pT
pT
pT
pT
pT
pT
pT
pT
pT
pT
pT
pT
pT
pT
pT
DJ
"}
(3,1,1) = {"
DJ
pT
fd
pT
pT
oY
mX
pT
pT
pT
mX
mX
mX
mX
pT
pT
pT
mH
pT
DJ
"}
(4,1,1) = {"
DJ
pT
pT
Ky
tY
ld
mX
pT
pT
pT
pT
pT
ss
mX
pT
pT
pT
Vl
pT
DJ
"}
(5,1,1) = {"
DJ
pT
pT
pT
LG
mX
PT
pT
SV
pT
pT
pT
be
mX
mX
pT
pT
rW
pT
DJ
"}
(6,1,1) = {"
DJ
pT
MW
GL
mX
mX
pT
pT
pT
pT
pT
pT
pT
pT
mX
mX
qQ
Wr
pT
DJ
"}
(7,1,1) = {"
DJ
pT
mX
mX
mX
pT
pT
pT
hX
hX
xO
hX
pT
pT
pT
mX
mX
mX
pT
DJ
"}
(8,1,1) = {"
DJ
pT
pT
pT
pT
pT
pT
hX
pT
cR
Sd
CJ
hX
pT
pT
pT
pT
mX
pT
DJ
"}
(9,1,1) = {"
DJ
pT
pT
pT
pT
pT
hX
jD
BS
We
jd
PH
gO
hX
pT
pT
pT
pT
pT
pT
"}
(10,1,1) = {"
DJ
pT
pT
pT
pT
pT
Ll
eD
pT
jw
pT
Iz
pT
Ll
pT
pT
pT
pT
pT
pT
"}
(11,1,1) = {"
DJ
pT
pT
pT
SV
pT
Ll
Za
Pq
Zh
cA
Iz
pT
Ll
pT
pT
pT
pT
pT
pT
"}
(12,1,1) = {"
DJ
pT
pT
pT
pT
pT
hX
Bu
CK
pT
sM
pT
Bu
hX
pT
SV
pT
pT
pT
pT
"}
(13,1,1) = {"
DJ
pT
pT
pT
pT
pT
pT
hX
pT
pT
pT
uU
hX
pT
pT
pT
pT
mX
pT
DJ
"}
(14,1,1) = {"
DJ
pT
mX
Ci
mX
pT
pT
pT
hX
kU
hX
hX
pT
pT
pT
mX
mX
mX
pT
DJ
"}
(15,1,1) = {"
DJ
pT
mX
pT
mX
mX
pT
pT
pT
pT
pT
pT
pT
pT
mX
mX
pT
hj
pT
DJ
"}
(16,1,1) = {"
DJ
pT
mX
pT
ZD
mX
mX
UM
pT
pT
pT
SV
pT
mX
mX
UV
rH
uC
pT
DJ
"}
(17,1,1) = {"
DJ
pT
mX
pT
pT
ZD
mX
UM
pT
pT
pT
pT
pT
mX
pT
pT
pT
qD
pT
DJ
"}
(18,1,1) = {"
DJ
pT
mX
mX
mX
mX
mX
mX
mX
pT
pT
pT
mX
mX
ZY
cp
pT
qk
pT
DJ
"}
(19,1,1) = {"
DJ
pT
pT
pT
pT
pT
pT
pT
pT
pT
pT
pT
pT
pT
pT
pT
pT
pT
pT
DJ
"}
(20,1,1) = {"
DJ
DJ
DJ
DJ
DJ
DJ
DJ
DJ
DJ
DJ
DJ
DJ
DJ
DJ
DJ
DJ
DJ
DJ
DJ
DJ
"}

(1,1,2) = {"
DJ
DJ
DJ
DJ
DJ
DJ
DJ
hX
UI
UI
UI
hX
DJ
DJ
DJ
DJ
DJ
DJ
DJ
DJ
"}
(2,1,2) = {"
DJ
xX
xX
xX
xX
xX
XA
hX
UI
UI
UI
hX
xX
xX
xX
xX
xX
xX
xX
DJ
"}
(3,1,2) = {"
DJ
xX
xX
xX
xX
xX
hX
hX
UI
UI
UI
hX
hX
hX
hX
xX
xX
xX
xX
DJ
"}
(4,1,2) = {"
DJ
xX
xX
xX
xX
xX
hX
UI
Ot
vT
vT
tz
xX
UI
hX
xX
xX
xX
xX
DJ
"}
(5,1,2) = {"
DJ
xX
xX
xX
xX
hX
hX
UI
vT
vT
Ot
tz
xX
UI
hX
xX
xX
xX
xX
DJ
"}
(6,1,2) = {"
DJ
xX
xX
xX
hX
hX
UI
UI
Ub
vT
vT
HQ
iH
UI
hX
hX
xX
xX
xX
DJ
"}
(7,1,2) = {"
DJ
xX
hX
hX
hX
if
UI
Qa
cg
cg
cg
cg
pA
UI
UI
hX
hX
hX
xX
DJ
"}
(8,1,2) = {"
DJ
xX
hX
Xa
hX
Xx
hX
hX
xX
xX
xX
xX
hX
pA
UI
UI
UI
hX
hX
hX
"}
(9,1,2) = {"
DJ
xX
aT
UI
UI
UI
Jk
xX
xX
xX
xX
xX
xX
mo
ZW
ZW
UI
UI
UI
UI
"}
(10,1,2) = {"
DJ
xX
hX
UI
UI
ce
wq
xX
xX
xX
xX
xX
xX
xB
yW
yW
UI
UI
UI
UI
"}
(11,1,2) = {"
DJ
xX
hX
UI
UI
EG
My
xX
xX
xX
xX
xX
xX
Cr
ka
TT
UI
UI
UI
UI
"}
(12,1,2) = {"
DJ
xX
aT
UI
UI
UI
Jk
xX
xX
xX
xX
xX
xX
qY
Nd
Qp
UI
UI
UI
UI
"}
(13,1,2) = {"
DJ
xX
hX
zX
hX
mL
hX
hX
xX
xX
xX
xX
hX
UI
UI
UI
UI
hX
hX
hX
"}
(14,1,2) = {"
DJ
xX
hX
hX
hX
UI
UI
Oo
iH
iH
iH
iH
hQ
UI
UI
hX
hX
hX
xX
DJ
"}
(15,1,2) = {"
DJ
xX
xX
xX
hX
hX
UI
cg
aK
EH
TM
EH
UI
UI
hX
hX
xX
xX
xX
DJ
"}
(16,1,2) = {"
DJ
xX
xX
xX
xX
hX
UI
xX
gI
UI
UI
UI
UI
hX
hX
xX
xX
xX
xX
DJ
"}
(17,1,2) = {"
DJ
xX
xX
xX
xX
hX
UI
xX
gI
Vr
zL
iE
PG
hX
xX
xX
xX
xX
xX
DJ
"}
(18,1,2) = {"
DJ
xX
xX
xX
xX
hX
hX
hX
hX
hX
hX
hX
hX
hX
xX
xX
xX
xX
xX
DJ
"}
(19,1,2) = {"
DJ
xX
xX
xX
xX
xX
xX
xX
xX
xX
xX
xX
xX
xX
xX
xX
xX
xX
xX
DJ
"}
(20,1,2) = {"
DJ
DJ
DJ
DJ
DJ
DJ
DJ
DJ
DJ
DJ
DJ
DJ
DJ
DJ
DJ
DJ
DJ
DJ
DJ
DJ
"}
