//MAP CONVERTED BY dmm2tgm.py THIS HEADER COMMENT PREVENTS RECONVERSION, DO NOT REMOVE
"bi" = (
/obj/structure/chair/bench/couch/redright,
/turf/open/floor/rogue/ruinedwood/spiralfade,
/area/rogue)
"bm" = (
/turf/closed/mineral/rogue/bedrock,
/area/rogue)
"ch" = (
/obj/structure/closet/crate/roguecloset/inn/chest,
/turf/open/floor/rogue/ruinedwood/spiralfade,
/area/rogue)
"cT" = (
/obj/structure/fluff/railing/border{
	dir = 9
	},
/turf/open/floor/rogue/ruinedwood/spiralfade,
/area/rogue)
"dB" = (
/obj/structure/well,
/turf/open/floor/rogue/dirt,
/area/rogue)
"dL" = (
/obj/structure/fluff/railing/border{
	dir = 8
	},
/turf/open/floor/rogue/ruinedwood/spiralfade,
/area/rogue)
"ex" = (
/obj/structure/closet/crate/roguecloset/inn,
/turf/open/floor/rogue/ruinedwood/spiralfade,
/area/rogue)
"hf" = (
/obj/structure/bed/rogue/inn/double,
/turf/open/floor/rogue/ruinedwood/spiralfade,
/area/rogue)
"hl" = (
/obj/structure/closet/crate/drawer/inn,
/turf/open/floor/rogue/ruinedwood/spiralfade,
/area/rogue)
"hq" = (
/obj/structure/floordoor/gatehatch/inner,
/obj/structure/fluff/walldeco/innsign/saiga,
/turf/open/floor/rogue/dirt,
/area/rogue)
"hr" = (
/obj/structure/chair/stool/rogue{
	pixel_x = 3;
	pixel_y = -1
	},
/turf/open/floor/rogue/ruinedwood/spiralfade,
/area/rogue)
"hy" = (
/obj/structure/fluff/railing/border,
/obj/structure/fluff/railing/border,
/turf/open/floor/rogue/ruinedwood/spiralfade,
/area/rogue)
"hM" = (
/obj/structure/fluff/walldeco/vinez/offset,
/turf/open/floor/rogue/ruinedwood/spiralfade,
/area/rogue)
"iY" = (
/obj/structure/fluff/railing/border{
	dir = 4
	},
/obj/structure/fluff/railing/border{
	dir = 4
	},
/turf/open/floor/rogue/ruinedwood/spiralfade,
/area/rogue)
"jn" = (
/obj/structure/chair/wood,
/turf/open/floor/rogue/ruinedwood/spiralfade,
/area/rogue)
"jV" = (
/obj/structure/mineral_door/wood,
/obj/item/restraints/legcuffs/beartrap/armed,
/turf/open/floor/rogue/ruinedwood/spiralfade,
/area/rogue)
"kC" = (
/obj/structure/toilet,
/mob/living/carbon/human/species/orc/npc,
/obj/effect/mapping_helpers/outfit_handler{
	outfit_to_equip = /datum/outfit/job/roguetown/adventurer/barbarian
	},
/turf/open/floor/rogue/ruinedwood/spiralfade,
/area/rogue)
"la" = (
/turf/closed/wall/mineral/rogue/decowood,
/area/rogue)
"mp" = (
/obj/item/chair/rogue/crafted,
/turf/open/floor/rogue/ruinedwood/spiralfade,
/area/rogue)
"mD" = (
/obj/structure/fluff/walldeco/innsign/saiga,
/turf/open/floor/rogue/dirt,
/area/rogue)
"of" = (
/obj/structure/fermenting_barrel/random/beer,
/turf/open/floor/rogue/ruinedwood/spiralfade,
/area/rogue)
"oF" = (
/obj/structure/bars/pipe/left,
/mob/living/carbon/human/species/skeleton/npc/ambush,
/turf/open/water/bath,
/area/rogue)
"ph" = (
/obj/structure/fluff/railing/border{
	dir = 1
	},
/turf/open/floor/rogue/ruinedwood/spiralfade,
/area/rogue)
"pm" = (
/obj/structure/fluff/walldeco/innsign/trophy,
/turf/open/floor/rogue/ruinedwood/spiralfade,
/area/rogue)
"px" = (
/turf/open/floor/rogue/rooftop/green{
	dir = 1
	},
/area/rogue)
"qI" = (
/turf/open/floor/rogue/ruinedwood/spiral,
/area/rogue)
"rv" = (
/obj/machinery/light/rogue/torchholder/l,
/obj/structure/fluff/walldeco/vinez/l,
/turf/open/floor/rogue/ruinedwood/spiralfade,
/area/rogue)
"ug" = (
/obj/structure/table/wood/large_alt,
/obj/item/reagent_containers/glass/cup/wooden/crafted{
	pixel_y = -5;
	pixel_x = 13
	},
/turf/open/floor/rogue/ruinedwood/spiralfade,
/area/rogue)
"ui" = (
/obj/structure/fluff/walldeco/vinez,
/turf/closed/wall/mineral/rogue/decowood/vert,
/area/rogue)
"uo" = (
/turf/open/floor/rogue/rooftop/green{
	dir = 8
	},
/area/rogue)
"uD" = (
/obj/structure/closet/crate/roguecloset/inn/south,
/turf/open/floor/rogue/ruinedwood/spiralfade,
/area/rogue)
"vn" = (
/obj/item/bath/soap,
/turf/open/water/bath,
/area/rogue)
"vp" = (
/obj/structure/stairs/d{
	dir = 4
	},
/turf/open/floor/rogue/ruinedwood/spiralfade,
/area/rogue)
"vs" = (
/turf/closed/wall/mineral/rogue/stone/moss,
/area/rogue)
"vI" = (
/obj/structure/roguewindow,
/turf/closed/wall/mineral/rogue/decowood,
/area/rogue)
"wL" = (
/obj/structure/table/wood/large/corner_alt,
/obj/item/reagent_containers/glass/cup/wooden/crafted{
	pixel_x = -6;
	pixel_y = 16
	},
/turf/open/floor/rogue/ruinedwood/spiralfade,
/area/rogue)
"wU" = (
/obj/machinery/light/rogue/oven/west,
/turf/open/floor/rogue/ruinedwood/spiralfade,
/area/rogue)
"xG" = (
/obj/machinery/light/rogue/hearth,
/obj/item/reagent_containers/glass/bucket/pot,
/turf/open/floor/rogue/ruinedwood/spiralfade,
/area/rogue)
"yI" = (
/obj/machinery/light/rogue/chand,
/turf/open/transparent/openspace,
/area/rogue)
"yW" = (
/obj/machinery/light/rogue/torchholder/r,
/turf/open/floor/rogue/ruinedwood/spiralfade,
/area/rogue)
"Ae" = (
/obj/item/bath/soap,
/obj/structure/mineral_door/wood/deadbolt{
	dir = 1
	},
/turf/open/floor/rogue/ruinedwood/spiralfade,
/area/rogue)
"Ao" = (
/obj/structure/table/wood/large/corner_alt,
/turf/open/floor/rogue/ruinedwood/spiralfade,
/area/rogue)
"Bl" = (
/obj/structure/chair/stool/rogue,
/turf/open/floor/rogue/ruinedwood/spiralfade,
/area/rogue)
"BL" = (
/obj/machinery/light/rogue/hearth,
/obj/item/cooking/pan,
/turf/open/floor/rogue/ruinedwood/spiralfade,
/area/rogue)
"BT" = (
/obj/structure/bed/rogue/bear{
	pixel_x = 0;
	pixel_y = -6
	},
/turf/open/floor/rogue/ruinedwood/spiralfade,
/area/rogue)
"CL" = (
/obj/structure/fluff/railing/border{
	dir = 6
	},
/turf/open/floor/rogue/ruinedwood/spiralfade,
/area/rogue)
"EL" = (
/turf/closed/wall/mineral/rogue/decowood/vert,
/area/rogue)
"Fo" = (
/obj/structure/rack/rogue/shelf/big,
/turf/open/floor/rogue/ruinedwood/spiralfade,
/area/rogue)
"FI" = (
/obj/item/chair/stool/bar/rogue,
/turf/open/floor/rogue/ruinedwood/spiralfade,
/area/rogue)
"GW" = (
/obj/structure/chair/bench/couch/redleft,
/turf/open/floor/rogue/ruinedwood/spiralfade,
/area/rogue)
"He" = (
/obj/structure/table/wood/large_alt,
/obj/item/reagent_containers/glass/cup/wooden/crafted{
	pixel_x = 9
	},
/turf/open/floor/rogue/ruinedwood/spiralfade,
/area/rogue)
"Hm" = (
/obj/machinery/light/rogue/chand,
/obj/item/roguecoin/copper/pile,
/turf/open/transparent/openspace,
/area/rogue)
"Hp" = (
/turf/open/floor/rogue/dirt,
/area/rogue)
"HO" = (
/obj/structure/fluff/walldeco/vinez/l,
/turf/open/floor/rogue/ruinedwood/spiralfade,
/area/rogue)
"HR" = (
/turf/open/floor/rogue/rooftop/green,
/area/rogue)
"Ij" = (
/obj/structure/mineral_door/wood,
/turf/open/floor/rogue/ruinedwood/spiralfade,
/area/rogue)
"Iy" = (
/obj/machinery/light/rogue/wallfire{
	pixel_x = 16
	},
/turf/closed/wall/mineral/rogue/decowood/vert,
/area/rogue)
"IM" = (
/turf/open/transparent/openspace,
/area/rogue)
"IQ" = (
/obj/structure/fluff/walldeco/innsign,
/turf/closed/wall/mineral/rogue/stone/moss,
/area/rogue)
"Jg" = (
/obj/structure/chair/stool/rogue{
	pixel_x = -5
	},
/turf/open/floor/rogue/ruinedwood/spiralfade,
/area/rogue)
"Jk" = (
/turf/open/water/bath,
/area/rogue)
"JS" = (
/obj/structure/rack/rogue/shelf/biggest,
/obj/item/reagent_containers/food/snacks/rogue/meat/salami{
	pixel_y = -2;
	pixel_x = -1
	},
/obj/item/reagent_containers/food/snacks/rogue/meat/salami{
	pixel_x = -2;
	pixel_y = 10
	},
/turf/open/floor/rogue/ruinedwood/spiralfade,
/area/rogue)
"Km" = (
/obj/structure/table/wood/large/corner_alt,
/obj/item/reagent_containers/food/snacks/rotten/sausage{
	pixel_y = 4
	},
/turf/open/floor/rogue/ruinedwood/spiralfade,
/area/rogue)
"KZ" = (
/turf/open/floor/rogue/naturalstone,
/area/rogue)
"Lu" = (
/turf/open/floor/rogue/rooftop/green{
	dir = 4
	},
/area/rogue)
"LB" = (
/obj/structure/roguewindow,
/obj/structure/fluff/walldeco/vinez,
/turf/closed/wall/mineral/rogue/decowood/vert,
/area/rogue)
"LU" = (
/obj/structure/fluff/walldeco/vinez,
/obj/structure/roguewindow,
/turf/closed/wall/mineral/rogue/decowood/vert,
/area/rogue)
"LZ" = (
/obj/structure/chair/wood{
	dir = 4
	},
/turf/open/floor/rogue/ruinedwood/spiralfade,
/area/rogue)
"Mk" = (
/turf/open/floor/rogue/ruinedwood/spiralfade,
/area/rogue)
"My" = (
/obj/structure/table/wood/plain,
/obj/item/reagent_containers/glass/bottle/rogue/wine/sourwine{
	pixel_y = 9
	},
/obj/item/reagent_containers/glass/bottle/rogue/wine/sourwine{
	pixel_y = 5;
	pixel_x = -7
	},
/obj/item/reagent_containers/glass/bottle/rogue/poison{
	pixel_y = 7;
	pixel_x = 8
	},
/turf/open/floor/rogue/ruinedwood/spiralfade,
/area/rogue)
"MF" = (
/obj/machinery/light/rogue/torchholder/l,
/turf/open/floor/rogue/ruinedwood/spiralfade,
/area/rogue)
"Ok" = (
/obj/structure/roguewindow/openclose,
/turf/closed/wall/mineral/rogue/stone/moss,
/area/rogue)
"Pa" = (
/obj/structure/table/wood/plain,
/obj/item/rogueweapon/knife/cleaver,
/obj/structure/fluff/walldeco/bigpainting/lake,
/turf/open/floor/rogue/ruinedwood/spiralfade,
/area/rogue)
"Pc" = (
/obj/structure/table/wood/counter{
	dir = 4
	},
/turf/open/floor/rogue/ruinedwood/spiralfade,
/area/rogue)
"Pn" = (
/obj/structure/fluff/railing/border{
	dir = 5
	},
/turf/open/floor/rogue/ruinedwood/spiralfade,
/area/rogue)
"Sn" = (
/mob/living/carbon/human/species/skeleton/npc/ambush,
/turf/open/water/bath,
/area/rogue)
"TY" = (
/obj/structure/bed/rogue/inn,
/turf/open/floor/rogue/ruinedwood/spiralfade,
/area/rogue)
"Ur" = (
/obj/structure/fluff/walldeco/painting/queen,
/turf/closed/wall/mineral/rogue/stone/moss,
/area/rogue)
"UV" = (
/obj/structure/fluff/walldeco/bath/wallpipes,
/turf/open/floor/rogue/ruinedwood/spiralfade,
/area/rogue)
"Vv" = (
/obj/structure/fluff/railing/border,
/turf/open/floor/rogue/ruinedwood/spiralfade,
/area/rogue)
"Vx" = (
/obj/structure/table/wood/counter{
	dir = 4
	},
/obj/item/reagent_containers/glass/cup/wooden/crafted{
	pixel_x = -6;
	pixel_y = 16
	},
/obj/item/reagent_containers/glass/cup/wooden/crafted{
	pixel_y = -8
	},
/obj/item/reagent_containers/glass/cup/wooden/crafted{
	pixel_x = 4;
	pixel_y = 14
	},
/turf/open/floor/rogue/ruinedwood/spiralfade,
/area/rogue)
"VY" = (
/obj/structure/fluff/walldeco/vinez/r,
/turf/open/floor/rogue/ruinedwood/spiralfade,
/area/rogue)
"Wy" = (
/obj/effect/mapping_helpers/outfit_handler{
	outfit_to_equip = /datum/outfit/job/roguetown/adventurer/barbarian
	},
/mob/living/carbon/human/species/orc/npc,
/turf/open/floor/rogue/ruinedwood/spiralfade,
/area/rogue)
"WA" = (
/obj/structure/fluff/railing/border{
	dir = 4
	},
/turf/open/floor/rogue/ruinedwood/spiralfade,
/area/rogue)
"WZ" = (
/obj/structure/mineral_door/wood/window,
/turf/closed/wall/mineral/rogue/stone/moss,
/area/rogue)
"Xw" = (
/obj/structure/fluff/railing/border{
	dir = 10
	},
/turf/open/floor/rogue/ruinedwood/spiralfade,
/area/rogue)
"Yx" = (
/obj/item/reagent_containers/powder/moondust{
	pixel_x = 5
	},
/obj/item/reagent_containers/powder/moondust{
	pixel_y = -5;
	pixel_x = -13
	},
/obj/item/reagent_containers/powder/moondust{
	pixel_y = 12;
	pixel_x = -7
	},
/obj/effect/decal/cleanable/blood,
/obj/item/rogueweapon/knife/hunting{
	pixel_y = -2;
	pixel_x = -14
	},
/turf/open/floor/rogue/ruinedwood/spiralfade,
/area/rogue)

(1,1,1) = {"
bm
bm
bm
bm
bm
bm
bm
bm
bm
KZ
KZ
bm
bm
bm
bm
bm
bm
bm
bm
bm
"}
(2,1,1) = {"
bm
KZ
KZ
Hp
Hp
Hp
Hp
Hp
Hp
KZ
KZ
Hp
Hp
Hp
Hp
Hp
Hp
Hp
Hp
bm
"}
(3,1,1) = {"
bm
KZ
KZ
Hp
mD
Hp
Hp
Hp
Hp
KZ
KZ
Hp
Hp
Hp
Hp
Hp
hq
Hp
KZ
bm
"}
(4,1,1) = {"
bm
KZ
KZ
vs
vs
vs
Ok
vs
IQ
WZ
WZ
IQ
vs
Ok
vs
vs
vs
Hp
KZ
bm
"}
(5,1,1) = {"
bm
Hp
Hp
vs
GW
Ao
FI
Mk
EL
Mk
Mk
Mk
Mk
Mk
mp
Mk
vs
Hp
Hp
bm
"}
(6,1,1) = {"
bm
KZ
Hp
vs
bi
Ao
Bl
Mk
Iy
Jg
BT
Mk
jn
ug
Km
Mk
vs
Hp
Hp
bm
"}
(7,1,1) = {"
bm
KZ
Hp
Ok
Mk
Mk
KZ
Mk
EL
hr
Mk
Mk
Mk
He
wL
Mk
Ok
Hp
KZ
bm
"}
(8,1,1) = {"
bm
Hp
Hp
vs
la
la
la
Mk
EL
pm
Mk
Mk
Mk
Mk
LZ
Mk
Ok
Hp
Hp
bm
"}
(9,1,1) = {"
bm
Hp
Hp
Ur
Mk
Mk
Mk
Mk
Mk
Hp
Hp
mp
Mk
Mk
Mk
Mk
IQ
Hp
KZ
bm
"}
(10,1,1) = {"
KZ
KZ
KZ
WZ
Hp
Mk
Mk
Mk
Mk
Hp
Mk
Mk
Mk
Mk
Mk
Mk
WZ
KZ
KZ
KZ
"}
(11,1,1) = {"
KZ
KZ
KZ
WZ
Mk
Mk
Mk
Mk
Mk
Mk
Mk
Bl
FI
Bl
Mk
Mk
WZ
KZ
KZ
KZ
"}
(12,1,1) = {"
bm
Hp
KZ
vs
Mk
Mk
Mk
vs
vs
jV
vs
Vx
Pc
Pc
Pc
Pc
IQ
Hp
Hp
bm
"}
(13,1,1) = {"
bm
Hp
Hp
Ok
Mk
Hp
Mk
vs
ch
Mk
vs
Fo
Mk
Mk
Mk
of
vs
Hp
dB
bm
"}
(14,1,1) = {"
bm
KZ
Hp
vs
Mk
Mk
Mk
vs
ch
Wy
vs
Pa
Mk
Mk
Mk
of
Ok
Hp
Hp
bm
"}
(15,1,1) = {"
bm
Hp
Hp
vs
vp
vp
Mk
vs
JS
Mk
vs
My
Mk
Mk
Mk
Mk
Ok
Hp
KZ
bm
"}
(16,1,1) = {"
bm
Hp
Hp
vs
vs
vs
Ij
vs
ex
Mk
Ij
Mk
wU
wU
BL
xG
vs
Hp
Hp
bm
"}
(17,1,1) = {"
bm
Hp
Hp
vs
vs
kC
Mk
vs
vs
vs
vs
vs
vs
vs
vs
qI
vs
Hp
Hp
bm
"}
(18,1,1) = {"
bm
Hp
Hp
Hp
vs
vs
vs
vs
Hp
Hp
Hp
KZ
Hp
Hp
Hp
Hp
Hp
Hp
Hp
bm
"}
(19,1,1) = {"
bm
Hp
Hp
Hp
Hp
Hp
Hp
Hp
KZ
KZ
Hp
Hp
Hp
KZ
Hp
Hp
KZ
Hp
Hp
bm
"}
(20,1,1) = {"
bm
bm
bm
bm
bm
bm
bm
bm
KZ
KZ
bm
bm
bm
bm
bm
bm
bm
bm
bm
bm
"}

(1,1,2) = {"
bm
bm
bm
bm
bm
bm
bm
bm
bm
IM
IM
bm
bm
bm
bm
bm
bm
bm
bm
bm
"}
(2,1,2) = {"
bm
IM
IM
IM
IM
IM
IM
IM
IM
IM
IM
IM
IM
IM
IM
IM
IM
IM
IM
bm
"}
(3,1,2) = {"
bm
IM
IM
uo
uo
uo
uo
uo
uo
uo
uo
uo
uo
uo
uo
uo
uo
IM
IM
bm
"}
(4,1,2) = {"
bm
IM
px
vs
la
la
vI
EL
la
vI
EL
la
la
EL
la
vI
vs
HR
IM
bm
"}
(5,1,2) = {"
bm
IM
px
EL
uD
Mk
Mk
EL
hl
HO
EL
hl
Mk
EL
hl
HO
EL
HR
IM
bm
"}
(6,1,2) = {"
bm
IM
px
EL
hf
hl
Mk
EL
TY
Mk
EL
TY
IM
EL
TY
Mk
EL
HR
IM
bm
"}
(7,1,2) = {"
bm
IM
px
EL
la
la
Ij
EL
la
Ij
EL
la
Ij
EL
la
Ij
EL
HR
IM
bm
"}
(8,1,2) = {"
bm
IM
px
EL
Mk
rv
CL
WA
WA
WA
WA
iY
WA
Pn
MF
Mk
EL
HR
IM
bm
"}
(9,1,2) = {"
bm
IM
px
EL
Mk
IM
Vv
IM
IM
IM
IM
IM
IM
ph
IM
Mk
ui
HR
IM
bm
"}
(10,1,2) = {"
IM
IM
px
ui
Mk
Mk
hy
IM
Hm
IM
IM
yI
IM
ph
Mk
IM
LU
HR
IM
IM
"}
(11,1,2) = {"
IM
IM
px
EL
hM
Mk
IM
IM
IM
IM
IM
IM
IM
ph
Mk
Mk
EL
HR
IM
IM
"}
(12,1,2) = {"
bm
IM
px
ui
IM
Mk
Xw
dL
dL
dL
dL
dL
dL
cT
Mk
Mk
EL
HR
IM
bm
"}
(13,1,2) = {"
bm
IM
px
EL
Mk
Mk
Mk
EL
la
la
Ij
EL
EL
EL
EL
EL
EL
HR
IM
bm
"}
(14,1,2) = {"
bm
IM
px
EL
Mk
Mk
Mk
EL
hf
Mk
Mk
EL
uD
Mk
Sn
Jk
EL
HR
IM
bm
"}
(15,1,2) = {"
bm
IM
px
EL
IM
IM
Mk
EL
Mk
Mk
Mk
EL
UV
Yx
Jk
vn
LB
HR
IM
bm
"}
(16,1,2) = {"
bm
IM
px
EL
yW
VY
VY
EL
uD
Mk
Mk
Ae
Mk
Mk
oF
Jk
EL
HR
IM
bm
"}
(17,1,2) = {"
bm
IM
px
vs
la
la
la
la
la
vI
la
la
la
la
la
la
vs
HR
IM
bm
"}
(18,1,2) = {"
bm
IM
IM
Lu
Lu
Lu
Lu
Lu
Lu
Lu
Lu
Lu
Lu
Lu
Lu
Lu
Lu
IM
IM
bm
"}
(19,1,2) = {"
bm
IM
IM
IM
IM
IM
IM
IM
IM
IM
IM
IM
IM
IM
IM
IM
IM
IM
IM
bm
"}
(20,1,2) = {"
bm
bm
bm
bm
bm
bm
bm
bm
IM
IM
bm
bm
bm
bm
bm
bm
bm
bm
bm
bm
"}
