//MAP CONVERTED BY dmm2tgm.py THIS HEADER COMMENT PREVENTS RECONVERSION, DO NOT REMOVE
"a" = (
/turf/closed/mineral/rogue/bedrock,
/area/rogue)
"b" = (
/obj/item/reagent_containers/glass/bottle/rogue/beer/ratkept,
/obj/item/reagent_containers/glass/bottle/rogue/beer/ratkept,
/turf/open/floor/rogue/naturalstone,
/area/rogue)
"d" = (
/obj/item/natural/poo,
/turf/open/floor/rogue/naturalstone,
/area/rogue)
"i" = (
/obj/structure/bed/rogue/shit,
/mob/living/carbon/human/species/zizombie/npc/GRENZEL,
/turf/open/floor/rogue/naturalstone,
/area/rogue)
"l" = (
/obj/structure/roguetent,
/turf/open/floor/rogue/naturalstone,
/area/rogue)
"n" = (
/obj/item/roguecoin/silver,
/turf/open/floor/rogue/naturalstone,
/area/rogue)
"z" = (
/turf/open/transparent/openspace,
/area/rogue)
"D" = (
/obj/effect/decal/cleanable/vomit/old,
/turf/open/floor/rogue/naturalstone,
/area/rogue)
"H" = (
/turf/open/floor/rogue/naturalstone,
/area/rogue)
"J" = (
/obj/item/reagent_containers/glass/bottle/rogue/beer/ratkept,
/turf/open/floor/rogue/naturalstone,
/area/rogue)
"K" = (
/obj/structure/toilet,
/obj/structure/flora/roguegrass/maneater/real{
	pixel_y = 9
	},
/obj/item/roguecoin/silver{
	pixel_y = -2
	},
/turf/open/floor/rogue/naturalstone,
/area/rogue)
"U" = (
/obj/item/paper{
	pixel_y = 19
	},
/obj/item/paper{
	pixel_y = 4;
	pixel_x = 8
	},
/obj/item/paper{
	pixel_y = -4;
	pixel_x = -4
	},
/turf/open/floor/rogue/naturalstone,
/area/rogue)

(1,1,1) = {"
a
a
a
a
a
a
a
H
H
H
H
H
a
a
a
a
a
a
a
a
"}
(2,1,1) = {"
a
a
a
a
a
a
a
H
H
H
H
H
a
a
a
a
a
a
a
a
"}
(3,1,1) = {"
a
a
a
a
a
a
a
H
H
H
H
H
a
H
a
a
a
a
a
a
"}
(4,1,1) = {"
a
a
a
H
H
a
H
H
H
H
H
H
H
H
a
a
a
H
a
a
"}
(5,1,1) = {"
a
a
a
H
H
H
H
H
H
H
H
H
H
H
H
H
H
H
a
a
"}
(6,1,1) = {"
a
a
a
H
H
H
H
H
H
H
H
H
H
H
H
H
a
H
a
a
"}
(7,1,1) = {"
a
a
a
a
H
H
H
H
H
H
H
H
H
H
H
H
H
H
a
a
"}
(8,1,1) = {"
H
H
H
H
H
H
H
H
H
H
H
H
H
H
H
H
H
H
H
H
"}
(9,1,1) = {"
H
H
H
H
H
H
H
H
H
n
n
H
H
H
H
H
H
H
H
H
"}
(10,1,1) = {"
H
H
H
H
H
H
H
H
H
n
K
n
H
H
H
H
H
H
H
H
"}
(11,1,1) = {"
H
H
H
H
H
H
H
H
H
n
U
n
H
H
H
H
H
H
H
H
"}
(12,1,1) = {"
H
H
H
H
H
H
H
H
H
H
H
H
H
H
H
H
H
H
H
H
"}
(13,1,1) = {"
a
a
a
a
H
H
H
H
H
H
H
H
H
H
a
H
H
a
a
a
"}
(14,1,1) = {"
a
a
a
H
H
H
a
H
H
H
H
H
H
H
H
H
H
a
a
a
"}
(15,1,1) = {"
a
a
a
H
H
H
H
a
H
H
H
H
a
a
a
H
H
a
a
a
"}
(16,1,1) = {"
a
a
a
a
H
H
H
H
H
H
H
H
H
H
a
H
H
a
a
a
"}
(17,1,1) = {"
a
a
a
a
H
H
H
H
H
H
H
H
a
H
H
H
H
a
a
a
"}
(18,1,1) = {"
a
a
a
a
a
a
a
a
H
H
H
H
H
H
H
a
a
a
a
a
"}
(19,1,1) = {"
a
a
a
a
a
a
a
a
H
H
H
H
a
a
a
a
a
a
a
a
"}
(20,1,1) = {"
a
a
a
a
a
a
a
a
H
H
H
H
a
a
a
a
a
a
a
a
"}

(1,1,2) = {"
a
a
a
a
a
a
a
a
H
H
H
a
a
a
a
a
a
a
a
a
"}
(2,1,2) = {"
a
J
b
D
H
H
a
a
H
H
H
a
a
a
a
a
a
a
a
a
"}
(3,1,2) = {"
a
J
b
H
D
H
a
H
H
H
H
H
a
H
H
H
H
a
a
a
"}
(4,1,2) = {"
a
i
H
H
H
H
a
H
H
H
H
H
a
H
H
a
a
H
a
a
"}
(5,1,2) = {"
a
a
a
a
a
l
a
H
H
H
H
H
H
H
H
a
a
H
a
a
"}
(6,1,2) = {"
a
a
H
H
H
H
a
H
H
H
H
H
a
a
a
a
a
H
a
a
"}
(7,1,2) = {"
a
a
H
a
a
a
a
H
H
H
H
H
H
H
a
H
a
H
H
a
"}
(8,1,2) = {"
a
H
H
H
H
H
H
H
H
H
H
H
H
H
H
H
H
H
a
a
"}
(9,1,2) = {"
H
H
H
H
H
H
H
H
H
H
n
H
H
H
H
H
H
H
a
H
"}
(10,1,2) = {"
H
H
a
H
H
H
H
H
H
n
z
H
H
H
H
H
H
H
H
H
"}
(11,1,2) = {"
H
a
a
H
H
H
H
H
H
H
d
H
H
H
H
H
H
H
H
H
"}
(12,1,2) = {"
a
a
H
H
H
H
H
H
H
H
H
H
H
H
H
H
H
H
a
a
"}
(13,1,2) = {"
a
a
a
H
a
a
a
H
H
H
H
H
a
H
a
a
a
a
H
a
"}
(14,1,2) = {"
a
a
a
H
a
a
a
H
H
H
H
H
a
H
H
a
H
H
H
a
"}
(15,1,2) = {"
a
H
H
H
H
H
a
H
H
H
H
H
a
a
H
a
H
H
a
a
"}
(16,1,2) = {"
a
H
a
H
H
H
H
H
H
H
H
H
a
a
H
H
a
a
a
a
"}
(17,1,2) = {"
a
H
a
a
H
a
a
H
H
H
H
H
a
H
H
H
a
a
a
a
"}
(18,1,2) = {"
a
H
H
a
H
H
H
H
H
H
H
H
a
a
H
a
a
a
a
a
"}
(19,1,2) = {"
a
a
H
a
a
a
H
a
a
H
H
a
H
H
H
a
a
a
a
a
"}
(20,1,2) = {"
a
a
a
a
a
a
a
a
H
H
H
a
a
a
a
a
a
a
a
a
"}
