//MAP CONVERTED BY dmm2tgm.py THIS HEADER COMMENT PREVENTS RECONVERSION, DO NOT REMOVE
"a" = (
/turf/closed/wall/mineral/rogue/craftstone,
/area/rogue)
"b" = (
/turf/open/floor/rogue/hexstone,
/area/rogue)

(1,1,1) = {"
a
b
a
"}
(2,1,1) = {"
a
b
a
"}
(3,1,1) = {"
a
b
a
"}
(4,1,1) = {"
a
b
a
"}
(5,1,1) = {"
a
b
a
"}
(6,1,1) = {"
a
b
a
"}

(1,1,2) = {"
a
b
a
"}
(2,1,2) = {"
a
b
a
"}
(3,1,2) = {"
a
b
a
"}
(4,1,2) = {"
a
b
a
"}
(5,1,2) = {"
a
b
a
"}
(6,1,2) = {"
a
b
a
"}
