//MAP CONVERTED BY dmm2tgm.py THIS HEADER COMMENT PREVENTS RECONVERSION, DO NOT REMOVE
"a" = (
/turf/closed/mineral/rogue/bedrock,
/area/rogue)
"m" = (
/turf/open/transparent/openspace,
/area/rogue)
"C" = (
/turf/open/floor/rogue/naturalstone,
/area/rogue)

(1,1,1) = {"
a
a
a
C
C
C
C
a
a
a
"}
(2,1,1) = {"
a
a
C
C
C
a
C
a
a
a
"}
(3,1,1) = {"
a
a
C
a
C
a
C
C
a
a
"}
(4,1,1) = {"
C
a
C
a
C
C
C
C
C
C
"}
(5,1,1) = {"
C
C
C
a
a
a
a
a
C
C
"}
(6,1,1) = {"
C
C
C
C
C
C
C
a
C
C
"}
(7,1,1) = {"
C
C
a
C
a
a
C
a
C
C
"}
(8,1,1) = {"
a
C
a
a
a
C
C
a
C
a
"}
(9,1,1) = {"
a
C
C
C
C
C
C
C
C
a
"}
(10,1,1) = {"
a
a
a
C
C
C
C
a
a
a
"}

(1,1,2) = {"
a
a
a
C
C
C
C
a
a
a
"}
(2,1,2) = {"
a
a
C
C
C
a
C
a
a
a
"}
(3,1,2) = {"
a
a
C
a
C
a
C
m
a
a
"}
(4,1,2) = {"
C
a
m
a
C
m
C
m
C
C
"}
(5,1,2) = {"
C
C
C
a
a
a
a
a
C
C
"}
(6,1,2) = {"
C
C
C
C
C
m
C
a
C
C
"}
(7,1,2) = {"
C
C
a
m
a
a
C
a
C
C
"}
(8,1,2) = {"
a
C
a
a
a
C
C
a
m
a
"}
(9,1,2) = {"
a
C
C
C
C
C
C
m
C
a
"}
(10,1,2) = {"
a
a
a
C
C
C
C
a
a
a
"}
