//MAP CONVERTED BY dmm2tgm.py THIS HEADER COMMENT PREVENTS RECONVERSION, DO NOT REMOVE
"a" = (
/turf/closed/mineral/rogue/bedrock,
/area/rogue)
"f" = (
/obj/effect/decal/cleanable/blood/gibs/up,
/obj/effect/decal/cleanable/blood/footprints{
	dir = 4
	},
/turf/open/floor/rogue/naturalstone,
/area/rogue)
"i" = (
/obj/effect/decal/remains/troll,
/turf/open/floor/rogue/naturalstone,
/area/rogue)
"k" = (
/turf/open/floor/rogue/naturalstone,
/area/rogue)
"t" = (
/obj/effect/decal/cleanable/blood/footprints{
	dir = 4
	},
/turf/open/floor/rogue/naturalstone,
/area/rogue)
"w" = (
/obj/effect/decal/cleanable/blood/drip,
/turf/open/floor/rogue/naturalstone,
/area/rogue)
"N" = (
/turf/open/transparent/openspace,
/area/rogue)
"Q" = (
/obj/effect/decal/cleanable/blood/splatter,
/turf/open/floor/rogue/naturalstone,
/area/rogue)
"T" = (
/obj/effect/decal/remains/human,
/turf/open/floor/rogue/naturalstone,
/area/rogue)
"X" = (
/obj/effect/decal/remains/mole,
/turf/open/floor/rogue/naturalstone,
/area/rogue)
"Z" = (
/obj/effect/decal/remains/bogbug,
/turf/open/floor/rogue/naturalstone,
/area/rogue)

(1,1,1) = {"
a
k
k
k
a
a
a
a
a
a
a
k
k
k
a
a
a
a
a
a
"}
(2,1,1) = {"
k
w
k
k
k
k
Z
k
k
k
k
k
k
k
k
k
k
k
k
k
"}
(3,1,1) = {"
k
k
X
T
k
Q
k
k
k
k
k
k
k
f
k
k
k
k
k
k
"}
(4,1,1) = {"
k
k
T
k
k
k
k
k
i
k
k
k
k
t
k
k
k
k
k
k
"}
(5,1,1) = {"
a
w
k
k
a
a
a
a
a
a
a
k
k
t
a
a
a
a
a
a
"}

(1,1,2) = {"
a
k
k
k
a
a
a
a
a
a
a
k
k
k
a
a
a
a
a
a
"}
(2,1,2) = {"
k
N
N
k
k
k
N
k
N
N
k
k
k
k
N
k
N
k
N
k
"}
(3,1,2) = {"
k
k
N
N
k
k
N
k
N
N
N
N
N
N
N
N
N
N
N
k
"}
(4,1,2) = {"
k
k
k
N
N
k
N
k
k
k
k
N
k
k
k
N
k
N
k
k
"}
(5,1,2) = {"
a
k
k
k
a
a
a
a
a
a
a
k
k
k
a
a
a
a
a
a
"}
