//MAP CONVERTED BY dmm2tgm.py THIS HEADER COMMENT PREVENTS RECONVERSION, DO NOT REMOVE
"a" = (
/turf/open/floor/rogue/naturalstone,
/area/rogue)
"d" = (
/obj/item/restraints/legcuffs/beartrap/armed,
/obj/item/roguecoin/copper,
/turf/open/floor/rogue/naturalstone,
/area/rogue)
"y" = (
/turf/closed/mineral/rogue/bedrock,
/area/rogue)
"H" = (
/obj/structure/ladder/earth,
/turf/open/floor/rogue/naturalstone,
/area/rogue)

(1,1,1) = {"
y
y
y
y
y
a
a
a
a
y
y
y
y
y
y
"}
(2,1,1) = {"
y
a
a
a
a
H
a
a
a
y
a
a
a
d
y
"}
(3,1,1) = {"
y
a
y
y
y
y
y
y
y
y
a
y
y
d
y
"}
(4,1,1) = {"
y
a
a
a
d
a
H
y
H
a
a
y
H
a
y
"}
(5,1,1) = {"
y
a
y
y
a
y
y
y
y
y
y
y
y
y
y
"}
(6,1,1) = {"
y
a
a
d
a
y
H
a
d
H
y
a
H
y
a
"}
(7,1,1) = {"
y
y
y
y
y
y
y
y
y
y
y
d
y
y
a
"}
(8,1,1) = {"
a
a
a
a
y
H
d
H
y
H
a
a
y
H
a
"}
(9,1,1) = {"
a
a
a
H
y
y
y
y
y
y
y
y
y
a
a
"}
(10,1,1) = {"
y
y
y
y
y
a
H
y
H
y
H
y
H
a
a
"}
(11,1,1) = {"
y
H
y
a
a
d
y
y
d
y
d
y
y
y
y
"}
(12,1,1) = {"
y
a
y
H
a
a
y
H
a
y
H
y
H
d
y
"}
(13,1,1) = {"
y
a
y
y
y
y
y
y
y
y
y
y
y
y
y
"}
(14,1,1) = {"
y
d
a
H
y
a
a
H
a
a
a
a
a
H
y
"}
(15,1,1) = {"
y
y
y
y
y
a
a
a
a
a
y
y
y
y
y
"}

(1,1,2) = {"
y
y
y
y
y
a
a
a
a
y
y
y
y
y
y
"}
(2,1,2) = {"
y
y
y
y
y
H
a
a
a
y
y
y
y
y
y
"}
(3,1,2) = {"
y
y
y
y
y
y
y
y
y
y
y
y
y
y
y
"}
(4,1,2) = {"
y
y
y
y
y
y
H
y
H
y
y
y
H
y
y
"}
(5,1,2) = {"
y
y
y
y
y
y
a
y
a
d
y
y
d
y
y
"}
(6,1,2) = {"
y
a
y
y
y
y
H
y
y
H
y
y
H
y
a
"}
(7,1,2) = {"
a
a
y
y
y
y
y
y
y
y
y
y
y
y
a
"}
(8,1,2) = {"
a
a
y
y
y
H
y
H
d
H
y
y
y
H
a
"}
(9,1,2) = {"
a
a
y
H
y
d
y
y
y
y
y
y
y
a
a
"}
(10,1,2) = {"
y
a
y
a
y
a
H
y
H
d
H
y
H
y
a
"}
(11,1,2) = {"
y
H
y
a
y
d
y
y
y
y
y
y
d
y
y
"}
(12,1,2) = {"
y
y
y
H
y
a
a
H
y
y
H
y
H
y
y
"}
(13,1,2) = {"
y
y
y
d
y
y
y
y
y
y
d
y
a
y
y
"}
(14,1,2) = {"
y
y
y
H
y
a
a
H
a
y
a
a
d
H
y
"}
(15,1,2) = {"
y
y
y
y
y
a
a
a
a
a
y
y
y
y
y
"}
