//MAP CONVERTED BY dmm2tgm.py THIS HEADER COMMENT PREVENTS RECONVERSION, DO NOT REMOVE
"a" = (
/turf/open/floor/rogue/naturalstone,
/area/rogue)
"d" = (
/turf/open/floor/rogue/twig,
/area/rogue)
"i" = (
/turf/closed/mineral/rogue/bedrock,
/area/rogue)
"l" = (
/turf/open/floor/rogue/rooftop/green{
	dir = 8
	},
/area/rogue)
"n" = (
/obj/structure/table/wood/plain,
/obj/item/reagent_containers/food/snacks/rogue/crackerscooked,
/turf/open/floor/rogue/ruinedwood/turned/darker,
/area/rogue)
"q" = (
/obj/structure/table/wood/plain,
/turf/open/floor/rogue/ruinedwood/turned/darker,
/area/rogue)
"r" = (
/obj/machinery/light/rogue/firebowl,
/turf/closed/mineral/rogue/bedrock,
/area/rogue)
"A" = (
/obj/machinery/light/rogue/firebowl,
/turf/open/floor/rogue/ruinedwood/turned/darker,
/area/rogue)
"E" = (
/obj/structure/wallladder{
	dir = 8
	},
/turf/open/floor/rogue/naturalstone,
/area/rogue)
"F" = (
/turf/open/transparent/openspace,
/area/rogue)
"H" = (
/obj/structure/fluff/walldeco/vinez/offset,
/turf/open/floor/rogue/naturalstone,
/area/rogue)
"J" = (
/obj/effect/decal/remains/human{
	pixel_y = 12
	},
/obj/structure/bed/rogue/shit,
/turf/open/floor/rogue/ruinedwood/turned/darker,
/area/rogue)
"L" = (
/obj/structure/mineral_door/wood/donjon/stone,
/turf/open/floor/rogue/ruinedwood/turned/darker,
/area/rogue)
"M" = (
/obj/structure/table/wood/plain,
/obj/item/flashlight/flare/torch/lantern,
/turf/open/floor/rogue/ruinedwood/turned/darker,
/area/rogue)
"O" = (
/turf/closed/wall/mineral/rogue/wooddark/slitted,
/area/rogue)
"Q" = (
/obj/structure/fluff/walldeco/vinez,
/turf/closed/wall/mineral/rogue/wooddark/window,
/area/rogue)
"U" = (
/turf/open/floor/rogue/rooftop/green,
/area/rogue)
"V" = (
/turf/open/floor/rogue/ruinedwood/turned/darker,
/area/rogue)
"Y" = (
/obj/structure/ladder/unbreakable,
/turf/open/floor/rogue/ruinedwood/turned/darker,
/area/rogue)

(1,1,1) = {"
i
i
i
i
i
i
a
a
a
a
i
i
i
i
i
"}
(2,1,1) = {"
i
i
i
i
i
a
a
a
a
a
i
i
i
i
i
"}
(3,1,1) = {"
i
i
i
i
a
a
a
a
a
a
a
i
i
i
i
"}
(4,1,1) = {"
i
i
i
a
a
a
a
a
a
a
a
a
i
i
i
"}
(5,1,1) = {"
i
i
i
i
i
a
a
a
a
O
a
a
a
i
i
"}
(6,1,1) = {"
i
i
i
i
i
a
a
a
a
a
a
a
a
i
i
"}
(7,1,1) = {"
i
i
i
i
O
a
a
a
a
a
a
a
a
a
a
"}
(8,1,1) = {"
a
a
a
a
a
a
a
a
O
a
a
a
a
a
a
"}
(9,1,1) = {"
a
a
a
a
a
a
a
a
E
a
i
i
a
a
a
"}
(10,1,1) = {"
a
a
a
a
a
a
a
a
a
a
i
a
a
a
i
"}
(11,1,1) = {"
i
O
O
Q
O
L
O
H
a
i
i
a
i
i
i
"}
(12,1,1) = {"
i
V
V
V
V
V
O
a
a
a
i
i
i
i
i
"}
(13,1,1) = {"
i
Y
V
V
V
V
O
a
i
i
i
i
i
i
i
"}
(14,1,1) = {"
i
V
n
M
q
J
O
i
i
i
i
i
i
i
i
"}
(15,1,1) = {"
i
i
i
i
i
i
i
i
i
i
i
i
i
i
i
"}

(1,1,2) = {"
i
i
i
i
i
i
a
a
a
a
i
i
i
i
i
"}
(2,1,2) = {"
i
i
i
i
i
F
F
F
d
d
i
i
i
i
i
"}
(3,1,2) = {"
i
i
i
i
F
F
F
F
d
d
F
i
i
i
i
"}
(4,1,2) = {"
i
i
i
F
F
F
F
F
F
d
F
F
i
i
i
"}
(5,1,2) = {"
i
i
i
i
i
F
F
F
d
d
F
F
F
i
i
"}
(6,1,2) = {"
i
i
i
i
i
F
F
F
d
F
F
F
F
i
i
"}
(7,1,2) = {"
i
i
i
i
d
d
d
d
d
d
d
d
a
a
a
"}
(8,1,2) = {"
a
d
d
d
d
F
d
d
d
F
d
d
a
a
a
"}
(9,1,2) = {"
a
F
F
F
F
F
F
F
F
F
a
a
a
a
a
"}
(10,1,2) = {"
a
F
F
F
F
F
F
F
F
F
i
F
F
F
i
"}
(11,1,2) = {"
i
l
l
l
l
l
O
F
F
i
i
F
i
i
i
"}
(12,1,2) = {"
i
V
V
V
V
V
U
F
F
F
i
i
i
i
i
"}
(13,1,2) = {"
i
Y
V
V
V
V
U
F
i
i
i
i
i
i
i
"}
(14,1,2) = {"
i
A
V
V
V
V
U
i
i
i
i
i
i
i
r
"}
(15,1,2) = {"
i
i
i
i
i
i
i
i
i
i
i
i
i
i
i
"}
