//MAP CONVERTED BY dmm2tgm.py THIS HEADER COMMENT PREVENTS RECONVERSION, DO NOT REMOVE
"a" = (
/turf/open/floor/rogue/hexstone,
/area/rogue)
"T" = (
/turf/closed/wall/mineral/rogue/craftstone,
/area/rogue)

(1,1,1) = {"
T
T
T
T
T
"}
(2,1,1) = {"
T
a
a
a
a
"}
(3,1,1) = {"
T
a
a
a
a
"}
(4,1,1) = {"
T
a
a
T
T
"}
(5,1,1) = {"
T
a
a
T
T
"}

(1,1,2) = {"
T
T
T
T
T
"}
(2,1,2) = {"
T
a
a
a
a
"}
(3,1,2) = {"
T
a
a
a
a
"}
(4,1,2) = {"
T
a
a
T
T
"}
(5,1,2) = {"
T
a
a
T
T
"}
