//MAP CONVERTED BY dmm2tgm.py THIS HEADER COMMENT PREVENTS RECONVERSION, DO NOT REMOVE
"a" = (
/turf/open/floor/rogue/volcanic,
/area/rogue/outdoors/caves)
"c" = (
/obj/machinery/light/rogue/torchholder/l,
/obj/structure/fluff/walldeco/vinez/l,
/turf/open/floor/rogue/volcanic,
/area/rogue/outdoors/caves)
"d" = (
/obj/machinery/light/rogue/wallfire/candle/blue,
/obj/effect/decal/cleanable/blood,
/obj/effect/decal/cleanable/blood/drip,
/turf/open/floor/rogue/herringbone,
/area/rogue/outdoors/caves)
"f" = (
/obj/item/roguegem/diamond,
/obj/structure/fluff/walldeco/vinez/offset,
/obj/item/rogueweapon/pick/paxe,
/turf/open/floor/rogue/volcanic,
/area/rogue/outdoors/caves)
"i" = (
/obj/machinery/light/rogue/wallfire/candle/blue/r,
/turf/closed/wall/mineral/rogue/decostone,
/area/rogue/outdoors/caves)
"j" = (
/obj/structure/fluff/walldeco/vinez/offset,
/turf/open/floor/rogue/volcanic,
/area/rogue/outdoors/caves)
"m" = (
/obj/structure/fluff/walldeco/bigpainting,
/obj/structure/table/vtable,
/obj/item/reagent_containers/glass/cup/silver,
/obj/item/reagent_containers/food/snacks/rogue/cheddarwedge/aged,
/obj/item/reagent_containers/food/snacks/rogue/crackerscooked,
/obj/item/rogueweapon/knife/dagger/silver,
/turf/open/floor/rogue/herringbone,
/area/rogue/outdoors/caves)
"o" = (
/obj/structure/fluff/walldeco/vinez/r,
/turf/open/floor/rogue/volcanic,
/area/rogue/outdoors/caves)
"q" = (
/obj/structure/fluff/walldeco/stone,
/turf/closed/wall/mineral/rogue/decostone/center,
/area/rogue/outdoors/caves)
"t" = (
/obj/machinery/light/rogue/wallfire/candle/blue,
/turf/open/floor/rogue/herringbone,
/area/rogue/outdoors/caves)
"v" = (
/obj/structure/chair/wood/rogue/chair_noble/purple{
	dir = 8
	},
/obj/effect/decal/cleanable/blood/old,
/obj/effect/decal/cleanable/blood/drip,
/turf/open/floor/rogue/herringbone,
/area/rogue/outdoors/caves)
"x" = (
/turf/closed/wall/mineral/rogue/decostone,
/area/rogue/outdoors/caves)
"A" = (
/obj/structure/chair/wood/rogue/chair_noble/purple{
	dir = 4
	},
/turf/open/floor/rogue/herringbone,
/area/rogue/outdoors/caves)
"C" = (
/turf/closed/mineral/rogue/bedrock,
/area/rogue/outdoors/caves)
"D" = (
/obj/structure/bars/pipe/left,
/turf/closed/mineral/rogue/bedrock,
/area/rogue/outdoors/caves)
"E" = (
/obj/structure/fluff/walldeco/vinez,
/turf/closed/mineral/rogue/bedrock,
/area/rogue/outdoors/caves)
"J" = (
/turf/open/floor/rogue/herringbone,
/area/rogue/outdoors/caves)
"L" = (
/obj/machinery/light/rogue/torchholder/l,
/turf/open/floor/rogue/volcanic,
/area/rogue/outdoors/caves)
"M" = (
/turf/closed/wall/mineral/rogue/decostone/cand,
/area/rogue/outdoors/caves)
"N" = (
/obj/effect/decal/cleanable/blood/old,
/obj/effect/decal/cleanable/blood/drip,
/turf/open/floor/rogue/herringbone,
/area/rogue/outdoors/caves)
"O" = (
/obj/structure/flora/rogueshroom,
/turf/open/floor/rogue/volcanic,
/area/rogue/outdoors/caves)
"P" = (
/obj/structure/table/vtable/v2,
/obj/item/reagent_containers/glass/bottle/rogue/whitewine,
/obj/item/reagent_containers/glass/cup/silver,
/obj/item/reagent_containers/food/snacks/rogue/cheddarwedge/aged,
/obj/item/reagent_containers/food/snacks/rogue/crackerscooked,
/turf/open/floor/rogue/herringbone,
/area/rogue/outdoors/caves)
"R" = (
/turf/open/lava,
/area/rogue/outdoors/caves)
"S" = (
/obj/effect/decal/cleanable/blood/tracks,
/obj/effect/decal/cleanable/blood/footprints,
/turf/open/floor/rogue/herringbone,
/area/rogue/outdoors/caves)
"Y" = (
/obj/machinery/light/rogue/torchholder/r,
/obj/effect/landmark/chest_or_mimic,
/obj/item/rogueore/gold,
/obj/item/rogueore/gold,
/obj/item/clothing/neck/roguetown/psycross/silver/malum_steel,
/turf/open/floor/rogue/volcanic,
/area/rogue/outdoors/caves)
"Z" = (
/obj/machinery/light/rogue/wallfire/candle/blue/l,
/turf/closed/wall/mineral/rogue/decostone,
/area/rogue/outdoors/caves)

(1,1,1) = {"
C
a
C
C
"}
(2,1,1) = {"
C
a
c
C
"}
(3,1,1) = {"
D
R
a
E
"}
(4,1,1) = {"
D
R
a
E
"}
(5,1,1) = {"
C
f
a
E
"}
(6,1,1) = {"
C
j
O
C
"}
(7,1,1) = {"
C
j
Y
C
"}
(8,1,1) = {"
C
a
E
C
"}
(9,1,1) = {"
C
o
L
C
"}
(10,1,1) = {"
C
C
a
C
"}

(1,1,2) = {"
M
J
J
M
"}
(2,1,2) = {"
x
J
J
x
"}
(3,1,2) = {"
q
t
J
q
"}
(4,1,2) = {"
x
A
J
Z
"}
(5,1,2) = {"
x
m
J
x
"}
(6,1,2) = {"
x
P
N
x
"}
(7,1,2) = {"
x
v
S
i
"}
(8,1,2) = {"
q
d
J
q
"}
(9,1,2) = {"
x
J
J
x
"}
(10,1,2) = {"
M
J
J
M
"}
