//MAP CONVERTED BY dmm2tgm.py THIS HEADER COMMENT PREVENTS RECONVERSION, DO NOT REMOVE
"a" = (
/turf/open/floor/rogue/churchbrick,
/area/rogue/outdoors/caves)
"g" = (
/turf/open/floor/rogue/dirt/road,
/area/rogue/outdoors/caves)
"k" = (
/turf/closed/wall/mineral/rogue/decostone/fluffstone/reddish,
/area/rogue/outdoors/caves)
"o" = (
/obj/machinery/light/rogue/firebowl,
/turf/open/floor/rogue/dirt/road,
/area/rogue/outdoors/caves)
"v" = (
/mob/living/carbon/human/species/goblin/npc/ambush/cave,
/turf/open/floor/rogue/dirt/road,
/area/rogue/outdoors/caves)
"y" = (
/obj/machinery/light/rogue/torchholder/l,
/turf/open/floor/rogue/churchbrick,
/area/rogue/outdoors/caves)
"O" = (
/obj/machinery/light/rogue/torchholder/l,
/obj/effect/spawner/roguemap/hauntpile,
/turf/open/floor/rogue/churchbrick,
/area/rogue/outdoors/caves)
"S" = (
/obj/machinery/light/rogue/torchholder/r,
/turf/open/floor/rogue/churchbrick,
/area/rogue/outdoors/caves)
"U" = (
/turf/closed/mineral/rogue,
/area/rogue/outdoors/caves)

(1,1,1) = {"
U
U
g
U
U
"}
(2,1,1) = {"
U
U
g
g
U
"}
(3,1,1) = {"
U
o
v
g
g
"}
(4,1,1) = {"
g
g
g
U
g
"}
(5,1,1) = {"
U
g
g
U
U
"}
(6,1,1) = {"
U
U
g
U
U
"}

(1,1,2) = {"
k
S
a
S
k
"}
(2,1,2) = {"
k
k
a
k
k
"}
(3,1,2) = {"
a
O
a
y
a
"}
(4,1,2) = {"
a
S
a
S
a
"}
(5,1,2) = {"
k
k
a
k
k
"}
(6,1,2) = {"
k
y
a
y
k
"}
