//MAP CONVERTED BY dmm2tgm.py THIS HEADER COMMENT PREVENTS RECONVERSION, DO NOT REMOVE
"a" = (
/turf/open/floor/rogue/dirt/road,
/area/rogue/outdoors/caves)
"b" = (
/obj/structure/table/wood/nice/decorated,
/obj/item/candle/yellow/lit/infinite/strong/skull,
/obj/item/reagent_containers/glass/bottle/rogue/stronghealthpot,
/obj/item/roguecoin/gold,
/obj/item/reagent_containers/glass/bottle/rogue/redwine,
/turf/open/floor/rogue/ruinedwood/chevron,
/area/rogue/outdoors/caves)
"c" = (
/mob/living/carbon/human/species/orc/ambush,
/turf/open/floor/rogue/dirt/road,
/area/rogue/outdoors/caves)
"d" = (
/obj/structure/table/vtable/v2,
/obj/item/book/rogue/godofdreamsandnightmares,
/obj/item/natural/feather,
/turf/open/floor/rogue/ruinedwood/chevron,
/area/rogue/outdoors/caves)
"e" = (
/obj/item/rogueweapon/shield/tower/buckleriron,
/obj/item/rogueweapon/sword/khopesh,
/obj/item/roguecoin/copper/pile,
/obj/item/clothing/mask/rogue/facemask/copper,
/obj/item/clothing/neck/roguetown/gorget/copper,
/obj/item/clothing/wrists/roguetown/bracers/copper,
/obj/item/clothing/head/roguetown/helmet/coppercap,
/obj/item/clothing/suit/roguetown/armor/cuirass/copperchest,
/obj/structure/closet/crate/chest,
/turf/open/floor/rogue/cobblerock/alt,
/area/rogue/outdoors/caves)
"f" = (
/obj/machinery/light/rogue/firebowl/standing,
/turf/open/floor/rogue/dirt/road,
/area/rogue/outdoors/caves)
"j" = (
/turf/closed/wall/mineral/rogue/wooddark/horizontal,
/area/rogue/outdoors/caves)
"o" = (
/obj/structure/bookcase/random/legends,
/turf/open/floor/rogue/ruinedwood/chevron,
/area/rogue/outdoors/caves)
"p" = (
/obj/structure/table/vtable,
/obj/item/paper/scroll,
/obj/item/clothing/ring/gold,
/turf/open/floor/rogue/ruinedwood/chevron,
/area/rogue/outdoors/caves)
"q" = (
/turf/open/floor/rogue/cobblerock/alt,
/area/rogue/outdoors/caves)
"r" = (
/obj/structure/mineral_door/wood/fancywood,
/turf/open/floor/rogue/ruinedwood/chevron,
/area/rogue/outdoors/caves)
"s" = (
/obj/structure/fermenting_barrel/water,
/turf/open/floor/rogue/ruinedwood/chevron,
/area/rogue/outdoors/caves)
"u" = (
/obj/structure/fermenting_barrel/beer,
/turf/open/floor/rogue/ruinedwood/chevron,
/area/rogue/outdoors/caves)
"z" = (
/turf/closed/mineral/rogue/bedrock,
/area/rogue/outdoors/caves)
"B" = (
/obj/structure/chair/wood,
/turf/open/floor/rogue/ruinedwood/chevron,
/area/rogue/outdoors/caves)
"C" = (
/turf/closed/wall/mineral/rogue/wooddark/vertical,
/area/rogue/outdoors/caves)
"D" = (
/obj/machinery/light/rogue/wallfire/candle/weak/l,
/turf/open/floor/rogue/ruinedwood/chevron,
/area/rogue/outdoors/caves)
"H" = (
/obj/structure/table/wood/nice/decorated,
/obj/item/clothing/mask/cigarette/pipe/westman,
/obj/item/reagent_containers/food/snacks/produce/dry_westleach,
/obj/item/reagent_containers/food/snacks/produce/dry_westleach,
/obj/item/reagent_containers/food/snacks/produce/dry_westleach,
/obj/item/reagent_containers/glass/cup/skull,
/obj/item/reagent_containers/glass/cup/silver,
/turf/open/floor/rogue/ruinedwood/chevron,
/area/rogue/outdoors/caves)
"J" = (
/obj/machinery/light/rogue/wallfire/candle/r,
/mob/living/carbon/human/species/skeleton/npc/warrior/skilled,
/turf/open/floor/rogue/ruinedwood/chevron,
/area/rogue/outdoors/caves)
"K" = (
/obj/structure/table/wood/plain/alt,
/obj/machinery/light/rogue/wallfire/candle/weak/l,
/obj/item/reagent_containers/food/snacks/rogue/cheddar/aged,
/obj/item/reagent_containers/glass/cup/skull,
/turf/open/floor/rogue/cobblerock/alt,
/area/rogue/outdoors/caves)
"N" = (
/turf/closed/wall/mineral/rogue/wooddark/end,
/area/rogue/outdoors/caves)
"O" = (
/obj/structure/chair/wood/rogue/chair_noble/purple,
/turf/open/floor/rogue/ruinedwood/chevron,
/area/rogue/outdoors/caves)
"P" = (
/obj/machinery/light/rogue/wallfire/candle/r,
/turf/open/floor/rogue/ruinedwood/chevron,
/area/rogue/outdoors/caves)
"R" = (
/obj/structure/bed/rogue/shit,
/turf/open/floor/rogue/cobblerock/alt,
/area/rogue/outdoors/caves)
"V" = (
/turf/open/floor/rogue/ruinedwood/chevron,
/area/rogue/outdoors/caves)
"W" = (
/obj/structure/mineral_door/wood/donjon/stone,
/turf/open/floor/rogue/cobblerock/alt,
/area/rogue/outdoors/caves)
"X" = (
/obj/structure/bed/rogue/inn/double,
/turf/open/floor/rogue/ruinedwood/chevron,
/area/rogue/outdoors/caves)

(1,1,1) = {"
z
z
a
z
z
z
z
z
"}
(2,1,1) = {"
z
f
a
a
a
a
a
z
"}
(3,1,1) = {"
a
a
a
a
c
a
a
z
"}
(4,1,1) = {"
z
z
z
z
a
a
a
a
"}
(5,1,1) = {"
z
R
K
z
a
a
a
z
"}
(6,1,1) = {"
z
q
q
z
a
a
a
z
"}
(7,1,1) = {"
z
e
q
W
a
a
f
z
"}
(8,1,1) = {"
z
z
z
z
z
a
z
z
"}

(1,1,2) = {"
N
C
C
C
C
C
C
N
"}
(2,1,2) = {"
j
b
V
V
V
r
D
j
"}
(3,1,2) = {"
j
o
V
V
p
C
V
V
"}
(4,1,2) = {"
j
X
J
O
d
C
V
j
"}
(5,1,2) = {"
j
C
C
C
C
C
V
j
"}
(6,1,2) = {"
V
V
V
V
V
V
V
j
"}
(7,1,2) = {"
j
s
P
B
H
B
u
j
"}
(8,1,2) = {"
N
C
C
C
C
C
C
N
"}
