//MAP CONVERTED BY dmm2tgm.py THIS HEADER COMMENT PREVENTS RECONVERSION, DO NOT REMOVE
"bO" = (
/obj/structure/flora/rogueshroom,
/turf/open/floor/rogue/dirt/ambush,
/area/rogue/outdoors/caves)
"bY" = (
/turf/open/floor/rogue/dirt/ambush,
/area/rogue/outdoors/caves)
"cl" = (
/obj/machinery/light/rogue/wallfire/candle/r,
/obj/structure/fluff/statue/knight/interior/r,
/turf/open/floor/rogue/tile/checkeralt,
/area/rogue/outdoors/caves)
"cm" = (
/obj/structure/fluff/walldeco/rpainting/forest,
/turf/closed/wall/mineral/rogue/wood,
/area/rogue/outdoors/caves)
"cP" = (
/obj/structure/flora/rogueshroom,
/turf/open/floor/rogue/dirt/road,
/area/rogue/outdoors/caves)
"dv" = (
/obj/structure/fluff/walldeco/rpainting/crown,
/turf/closed/wall/mineral/rogue/wood,
/area/rogue/outdoors/caves)
"dE" = (
/obj/structure/flora/roguegrass/swampweed,
/turf/open/floor/rogue/dirt/ambush,
/area/rogue/outdoors/caves)
"ec" = (
/obj/machinery/light/rogue/torchholder/l,
/obj/structure/flora/roguegrass/swampweed,
/turf/open/floor/rogue/dirt/ambush,
/area/rogue/outdoors/caves)
"en" = (
/turf/closed/mineral/rogue/bedrock,
/area/rogue/outdoors/caves)
"eu" = (
/mob/living/simple_animal/hostile/retaliate/rogue/trufflepig,
/turf/open/water/swamp/deep,
/area/rogue/outdoors/caves)
"fl" = (
/obj/structure/fluff/walldeco/painting,
/turf/closed/wall/mineral/rogue/wood,
/area/rogue/outdoors/caves)
"gu" = (
/obj/machinery/light/rogue/torchholder/l,
/turf/open/floor/rogue/dirt/road,
/area/rogue/outdoors/caves)
"gI" = (
/obj/structure/table/wood/nice/decorated_alt,
/obj/item/roguecoin/gold,
/obj/item/rogueore/gold,
/obj/structure/closet/crate/chest/gold,
/turf/open/floor/rogue/carpet,
/area/rogue/outdoors/caves)
"jN" = (
/mob/living/simple_animal/hostile/retaliate/rogue/minotaur/axe/female,
/turf/open/floor/rogue/carpet,
/area/rogue/outdoors/caves)
"kv" = (
/obj/structure/fluff/statue/evil,
/turf/open/floor/rogue/tile/checkeralt,
/area/rogue/outdoors/caves)
"mz" = (
/obj/structure/flora/roguegrass/swampweed,
/turf/open/floor/rogue/dirt/road,
/area/rogue/outdoors/caves)
"mY" = (
/obj/machinery/light/rogue/torchholder/c,
/turf/open/floor/rogue/dirt/road,
/area/rogue/outdoors/caves)
"nl" = (
/obj/structure/table/wood/plain/alt,
/obj/item/rogueweapon/pitchfork/copper,
/obj/item/reagent_containers/glass/cup/wooden,
/obj/item/clothing/mask/cigarette/pipe,
/obj/item/reagent_containers/food/snacks/produce/swampweed_dried,
/turf/open/floor/rogue/blocks/paving/vert,
/area/rogue/outdoors/caves)
"pt" = (
/obj/machinery/light/rogue/torchholder/c,
/obj/structure/flora/roguegrass/swampweed,
/turf/open/floor/rogue/dirt/ambush,
/area/rogue/outdoors/caves)
"pv" = (
/obj/structure/fluff/dryingrack,
/turf/open/floor/rogue/blocks/paving/vert,
/area/rogue/outdoors/caves)
"pY" = (
/obj/machinery/light/rogue/torchholder/c,
/turf/open/floor/rogue/dirt/ambush,
/area/rogue/outdoors/caves)
"rv" = (
/obj/machinery/light/rogue/wallfire/candle/l,
/obj/structure/fluff/statue/knight/interior,
/turf/open/floor/rogue/tile/checkeralt,
/area/rogue/outdoors/caves)
"sj" = (
/obj/machinery/light/rogue/wallfire/candle/l,
/turf/open/floor/rogue/carpet,
/area/rogue/outdoors/caves)
"sK" = (
/obj/structure/table/wood/nice/decorated_alt,
/obj/item/roguecoin/gold,
/obj/item/roguestatue/gold/loot,
/obj/structure/closet/crate/chest/gold,
/turf/open/floor/rogue/carpet,
/area/rogue/outdoors/caves)
"te" = (
/obj/machinery/light/rogue/torchholder/r,
/turf/open/floor/rogue/dirt/road,
/area/rogue/outdoors/caves)
"tg" = (
/mob/living/simple_animal/hostile/retaliate/rogue/trufflepig,
/turf/open/floor/rogue/dirt/road,
/area/rogue/outdoors/caves)
"tx" = (
/obj/structure/table/wood/nice/decorated_alt,
/obj/item/roguecoin/gold,
/obj/item/roguestatue/gold,
/obj/structure/closet/crate/chest/gold,
/turf/open/floor/rogue/carpet,
/area/rogue/outdoors/caves)
"uc" = (
/obj/structure/table/wood/nice/decorated_alt,
/obj/item/roguecoin/gold,
/obj/item/clothing/ring/gold,
/obj/structure/closet/crate/chest/gold,
/turf/open/floor/rogue/carpet,
/area/rogue/outdoors/caves)
"vp" = (
/turf/open/floor/rogue/carpet,
/area/rogue/outdoors/caves)
"wC" = (
/obj/structure/chair/stool/rogue,
/turf/open/floor/rogue/blocks/paving/vert,
/area/rogue/outdoors/caves)
"wP" = (
/obj/machinery/light/rogue/torchholder/r,
/turf/open/floor/rogue/dirt/ambush,
/area/rogue/outdoors/caves)
"xS" = (
/obj/machinery/light/rogue/firebowl/standing,
/turf/open/floor/rogue/carpet,
/area/rogue/outdoors/caves)
"yG" = (
/turf/open/water/swamp,
/area/rogue/outdoors/caves)
"Ac" = (
/mob/living/simple_animal/hostile/retaliate/rogue/minotaur/axe,
/turf/open/floor/rogue/tile/checkeralt,
/area/rogue/outdoors/caves)
"AE" = (
/mob/living/simple_animal/hostile/retaliate/rogue/trufflepig,
/turf/open/floor/rogue/dirt/ambush,
/area/rogue/outdoors/caves)
"AH" = (
/turf/open/floor/rogue/blocks/paving/vert,
/area/rogue/outdoors/caves)
"BJ" = (
/obj/structure/bed/rogue/shit,
/turf/open/floor/rogue/blocks/paving/vert,
/area/rogue/outdoors/caves)
"Da" = (
/obj/machinery/light/rogue/wallfire/candle/r,
/turf/open/floor/rogue/carpet,
/area/rogue/outdoors/caves)
"Fu" = (
/obj/structure/mineral_door/wood/donjon/stone,
/turf/open/floor/rogue/blocks/paving/vert,
/area/rogue/outdoors/caves)
"Fv" = (
/obj/machinery/light/rogue/wallfire/candle/l,
/turf/open/floor/rogue/tile/checkeralt,
/area/rogue/outdoors/caves)
"Gb" = (
/obj/machinery/light/rogue/torchholder/r,
/obj/effect/landmark/chest_or_mimic,
/obj/item/roguecoin/copper/pile,
/obj/item/reagent_containers/glass/bottle/rogue/stronghealthpot,
/obj/item/reagent_containers/food/snacks/rogue/cheddar/aged,
/turf/open/floor/rogue/blocks/paving/vert,
/area/rogue/outdoors/caves)
"Gy" = (
/obj/structure/fluff/walldeco/painting/seraphina,
/obj/structure/fluff/walldeco/painting/seraphina,
/turf/closed/wall/mineral/rogue/wood,
/area/rogue/outdoors/caves)
"HP" = (
/obj/machinery/light/rogue/torchholder/l,
/obj/structure/fermenting_barrel/water,
/turf/open/floor/rogue/blocks/paving/vert,
/area/rogue/outdoors/caves)
"JX" = (
/obj/structure/flora/rogueshroom,
/turf/closed/mineral/rogue/bedrock,
/area/rogue/outdoors/caves)
"Ke" = (
/turf/open/water/swamp/deep,
/area/rogue/outdoors/caves)
"LB" = (
/obj/structure/mineral_door/wood/fancywood,
/turf/open/floor/rogue/carpet,
/area/rogue/outdoors/caves)
"LS" = (
/obj/structure/fluff/walldeco/painting/queen,
/turf/closed/wall/mineral/rogue/wood,
/area/rogue/outdoors/caves)
"OE" = (
/obj/machinery/light/rogue/torchholder/c,
/mob/living/simple_animal/hostile/retaliate/rogue/trufflepig,
/turf/open/floor/rogue/dirt/ambush,
/area/rogue/outdoors/caves)
"Qf" = (
/obj/structure/fluff/walldeco/rpainting,
/turf/closed/wall/mineral/rogue/wood,
/area/rogue/outdoors/caves)
"QX" = (
/turf/closed/wall/mineral/rogue/wood,
/area/rogue/outdoors/caves)
"UY" = (
/obj/structure/table/wood/nice/decorated_alt,
/obj/item/roguecoin/gold,
/obj/item/reagent_containers/glass/cup/golden,
/obj/structure/closet/crate/chest/gold,
/turf/open/floor/rogue/carpet,
/area/rogue/outdoors/caves)
"Vz" = (
/obj/machinery/light/rogue/wallfire/candle/r,
/turf/open/floor/rogue/tile/checkeralt,
/area/rogue/outdoors/caves)
"WO" = (
/obj/structure/table/wood/nice/decorated_alt,
/obj/item/roguecoin/gold,
/obj/item/ingot/gold,
/obj/structure/closet/crate/chest/gold,
/turf/open/floor/rogue/carpet,
/area/rogue/outdoors/caves)
"Yf" = (
/turf/open/floor/rogue/tile/checkeralt,
/area/rogue/outdoors/caves)
"Yi" = (
/obj/structure/table/wood/nice/decorated_alt,
/obj/item/clothing/mask/rogue/facemask/goldmask,
/obj/item/roguecoin/gold/pile,
/obj/item/storage/belt/rogue/leather/plaquegold,
/obj/structure/closet/crate/chest/gold,
/obj/item/reagent_containers/food/snacks/rogue/cheddar/aged,
/obj/item/reagent_containers/food/snacks/rogue/cheddar/aged,
/obj/item/lockpick,
/obj/item/lockpick,
/obj/item/lockpick,
/obj/item/lockpick,
/obj/item/lockpick,
/obj/item/lockpickring,
/turf/open/floor/rogue/carpet,
/area/rogue/outdoors/caves)
"YH" = (
/turf/open/floor/rogue/dirt/road,
/area/rogue/outdoors/caves)

(1,1,1) = {"
en
en
mY
en
en
en
en
mY
en
en
mY
en
en
"}
(2,1,1) = {"
en
cP
bY
ec
en
en
cP
YH
en
en
bY
YH
en
"}
(3,1,1) = {"
en
OE
bY
YH
cP
en
tg
YH
cP
en
bO
AE
en
"}
(4,1,1) = {"
YH
YH
YH
YH
YH
en
en
bY
dE
en
mz
te
en
"}
(5,1,1) = {"
en
en
en
yG
yG
yG
gu
bY
en
en
bY
en
en
"}
(6,1,1) = {"
en
BJ
en
en
Ke
en
cP
YH
YH
bY
bY
YH
YH
"}
(7,1,1) = {"
en
AH
HP
en
en
en
en
YH
en
en
pt
YH
en
"}
(8,1,1) = {"
en
AH
AH
AH
Fu
bY
YH
bY
ec
en
cP
YH
en
"}
(9,1,1) = {"
en
wC
nl
pv
en
pY
yG
yG
yG
en
en
YH
en
"}
(10,1,1) = {"
en
Gb
en
en
en
YH
en
yG
cP
en
en
mY
en
"}
(11,1,1) = {"
en
en
en
bO
bY
YH
en
yG
en
en
bY
tg
en
"}
(12,1,1) = {"
YH
YH
YH
bY
wP
bY
en
eu
en
bY
bY
JX
en
"}
(13,1,1) = {"
en
mY
en
en
en
YH
en
en
en
mY
en
en
en
"}

(1,1,2) = {"
QX
QX
LB
QX
QX
LB
QX
dv
LB
QX
QX
LB
QX
"}
(2,1,2) = {"
LB
sj
vp
Yf
rv
vp
Fv
Yf
vp
Fv
Yf
vp
QX
"}
(3,1,2) = {"
QX
Yf
sK
vp
vp
vp
xS
vp
vp
vp
tx
vp
LB
"}
(4,1,2) = {"
LS
Yf
vp
Yf
vp
Yf
kv
Yf
vp
Yf
vp
Yf
QX
"}
(5,1,2) = {"
LB
vp
vp
vp
WO
vp
vp
vp
UY
vp
vp
Yf
QX
"}
(6,1,2) = {"
QX
Yf
vp
Yf
vp
Ac
vp
Yf
vp
Yf
vp
vp
LB
"}
(7,1,2) = {"
fl
Yf
xS
kv
vp
vp
Yi
jN
vp
kv
xS
Yf
QX
"}
(8,1,2) = {"
LB
vp
vp
Yf
vp
Yf
vp
Yf
vp
Yf
vp
Yf
Gy
"}
(9,1,2) = {"
QX
Yf
vp
vp
uc
vp
vp
vp
WO
vp
vp
vp
LB
"}
(10,1,2) = {"
QX
Yf
vp
Yf
vp
Yf
kv
Yf
vp
Yf
vp
Yf
QX
"}
(11,1,2) = {"
LB
vp
UY
vp
vp
vp
xS
vp
vp
vp
gI
Yf
Qf
"}
(12,1,2) = {"
QX
vp
Vz
Yf
vp
Vz
Yf
vp
cl
Yf
vp
Da
LB
"}
(13,1,2) = {"
QX
LB
QX
QX
LB
QX
cm
LB
QX
QX
LB
QX
QX
"}
