//MAP CONVERTED BY dmm2tgm.py THIS HEADER COMMENT PREVENTS RECONVERSION, DO NOT REMOVE
"a" = (
/obj/item/paper/scroll,
/obj/structure/table/wood/plain,
/obj/item/natural/feather,
/turf/open/floor/rogue/cobblerock,
/area/rogue)
"b" = (
/obj/machinery/light/rogue/hearth,
/turf/open/floor/rogue/blocks,
/area/rogue)
"c" = (
/obj/structure/table/wood/plain,
/obj/item/rogueweapon/knife/hunting{
	pixel_y = 3;
	pixel_x = -5
	},
/obj/item/reagent_containers/food/snacks/rotten/mince{
	pixel_x = 6;
	pixel_y = 8
	},
/obj/item/reagent_containers/food/snacks/rogue/meat/salami{
	pixel_y = -1;
	pixel_x = -5
	},
/obj/item/reagent_containers/food/snacks/rogue/crackerscooked{
	pixel_y = 7;
	pixel_x = 9
	},
/obj/item/reagent_containers/food/snacks/rogue/crackerscooked{
	pixel_y = 7;
	pixel_x = 9
	},
/turf/open/floor/rogue/blocks,
/area/rogue)
"d" = (
/obj/item/clothing/neck/roguetown/psycross/silver,
/turf/open/floor/rogue/ruinedwood,
/area/rogue)
"e" = (
/mob/living/carbon/human/species/skeleton/npc/warrior/skilled,
/obj/structure/bed/rogue/mediocre,
/obj/item/organ/eyes,
/obj/effect/decal/cleanable/blood,
/obj/effect/decal/cleanable/blood/gibs/old,
/turf/open/floor/rogue/herringbone,
/area/rogue)
"f" = (
/obj/structure/closet/crate/chest/old_crate,
/obj/item/rogueweapon/sword/rapier/silver,
/obj/item/clothing/suit/roguetown/armor/cuirass,
/obj/item/clothing/mask/rogue/facemask,
/obj/item/organ/heart,
/obj/effect/decal/cleanable/blood,
/obj/item/reagent_containers/food/snacks/rogue/crackerscooked,
/turf/open/floor/rogue/herringbone,
/area/rogue)
"g" = (
/turf/open/floor/rogue/herringbone,
/area/rogue)
"h" = (
/turf/open/floor/rogue/ruinedwood,
/area/rogue)
"i" = (
/obj/effect/decal/cleanable/blood,
/turf/open/floor/rogue/herringbone,
/area/rogue)
"j" = (
/turf/closed/wall/mineral/rogue/wooddark,
/area/rogue)
"k" = (
/obj/effect/decal/cleanable/blood,
/turf/open/floor/rogue/dirt/road,
/area/rogue)
"l" = (
/turf/open/floor/rogue/dirt/road,
/area/rogue)
"m" = (
/obj/item/reagent_containers/food/snacks/rotten/meat,
/obj/effect/decal/cleanable/blood,
/turf/open/floor/rogue/ruinedwood,
/area/rogue)
"n" = (
/obj/effect/decal/cleanable/blood,
/turf/open/floor/rogue/cobblerock,
/area/rogue)
"o" = (
/obj/item/organ/lungs,
/turf/open/floor/rogue/dirt/road,
/area/rogue)
"p" = (
/obj/effect/decal/cleanable/blood,
/turf/open/floor/rogue/ruinedwood,
/area/rogue)
"q" = (
/obj/item/organ/brain,
/obj/effect/decal/cleanable/blood,
/turf/open/floor/rogue/ruinedwood,
/area/rogue)
"r" = (
/obj/structure/mineral_door/wood,
/turf/open/floor/rogue/cobblerock,
/area/rogue)
"s" = (
/obj/item/restraints/legcuffs/beartrap/armed,
/obj/item/reagent_containers/food/snacks/rogue/pie/cooked/apple,
/turf/open/floor/rogue/ruinedwood,
/area/rogue)
"t" = (
/obj/item/reagent_containers/food/snacks/rotten/meat,
/obj/item/organ/heart,
/obj/effect/decal/cleanable/blood,
/turf/open/floor/rogue/ruinedwood,
/area/rogue)
"u" = (
/obj/structure/barricade/rogue,
/obj/structure/barricade/rogue/crude,
/turf/open/floor/rogue/cobblerock,
/area/rogue)
"v" = (
/obj/effect/decal/cleanable/dirt/dust,
/turf/open/floor/rogue/blocks,
/area/rogue)
"w" = (
/obj/item/reagent_containers/glass/bucket/pot,
/obj/structure/table/wood/plain,
/turf/open/floor/rogue/blocks,
/area/rogue)
"x" = (
/obj/item/reagent_containers/glass/bottle,
/turf/open/floor/rogue/cobblerock,
/area/rogue)
"y" = (
/turf/closed/mineral/rogue/bedrock,
/area/rogue)
"z" = (
/obj/structure/bed/rogue/shit,
/mob/living/carbon/human/species/skeleton/npc/peasant,
/turf/open/floor/rogue/cobblerock,
/area/rogue)
"A" = (
/obj/structure/table/wood/plain,
/obj/item/needle,
/turf/open/floor/rogue/cobble,
/area/rogue)
"B" = (
/obj/item/organ/eyes,
/turf/open/floor/rogue/dirt/road,
/area/rogue)
"C" = (
/turf/open/floor/rogue/blocks,
/area/rogue)
"D" = (
/obj/effect/decal/cleanable/blood,
/mob/living/carbon/human/species/orc/tribal,
/turf/open/floor/rogue/dirt/road,
/area/rogue)
"E" = (
/obj/effect/decal/cleanable/blood/footprints{
	dir = 4
	},
/turf/open/floor/rogue/cobblerock,
/area/rogue)
"F" = (
/obj/item/organ/heart,
/obj/effect/decal/cleanable/blood,
/turf/open/floor/rogue/dirt/road,
/area/rogue)
"G" = (
/obj/structure/bed/rogue/shit,
/mob/living/carbon/human/species/skeleton/npc/peasant,
/obj/effect/decal/cleanable/dirt/dust,
/obj/effect/decal/cleanable/blood,
/obj/effect/decal/cleanable/blood/gibs/old,
/turf/open/floor/rogue/blocks,
/area/rogue)
"H" = (
/obj/item/restraints/legcuffs/beartrap/armed,
/obj/item/ingot/gold,
/turf/open/floor/rogue/cobblerock,
/area/rogue)
"I" = (
/obj/item/ingot/gold,
/turf/open/floor/rogue/ruinedwood,
/area/rogue)
"J" = (
/obj/effect/decal/cleanable/dirt/dust,
/turf/open/floor/rogue/cobble,
/area/rogue)
"K" = (
/obj/item/rogueweapon/knife/dagger/silver,
/obj/item/natural/stone,
/obj/item/natural/stone{
	pixel_y = -6;
	pixel_x = 4
	},
/obj/item/natural/stone{
	pixel_y = -12;
	pixel_x = -7
	},
/obj/item/natural/stone{
	pixel_y = 4;
	pixel_x = -7
	},
/obj/item/natural/stone{
	pixel_y = 7;
	pixel_x = 11
	},
/obj/effect/decal/cleanable/blood,
/turf/open/floor/rogue/cobblerock,
/area/rogue)
"L" = (
/mob/living/carbon/human/species/orc/tribal,
/turf/open/floor/rogue/dirt/road,
/area/rogue)
"M" = (
/obj/item/reagent_containers/food/snacks/rotten/meat,
/turf/open/floor/rogue/dirt/road,
/area/rogue)
"N" = (
/obj/structure/fermenting_barrel/random/water,
/obj/item/reagent_containers/glass/bowl,
/turf/open/floor/rogue/cobble,
/area/rogue)
"O" = (
/obj/item/organ/lungs,
/turf/open/floor/rogue/ruinedwood,
/area/rogue)
"P" = (
/turf/open/floor/rogue/cobblerock,
/area/rogue)
"Q" = (
/obj/item/clothing/mask/rogue/facemask/goldmask,
/turf/open/floor/rogue/ruinedwood,
/area/rogue)
"R" = (
/obj/effect/decal/cleanable/blood,
/mob/living/carbon/human/species/orc/tribal,
/turf/open/floor/rogue/ruinedwood,
/area/rogue)
"S" = (
/obj/item/organ/brain,
/turf/open/floor/rogue/ruinedwood,
/area/rogue)
"T" = (
/obj/item/reagent_containers/glass/bottle/rogue/beer,
/turf/open/floor/rogue/cobblerock,
/area/rogue)
"U" = (
/turf/closed/wall/mineral/rogue/tent,
/area/rogue)
"V" = (
/obj/item/organ/tongue,
/turf/open/floor/rogue/herringbone,
/area/rogue)
"W" = (
/turf/open/floor/rogue/cobble,
/area/rogue)
"X" = (
/obj/effect/decal/cleanable/dirt/dust,
/obj/structure/bed/rogue/mediocre,
/turf/open/floor/rogue/cobble,
/area/rogue)
"Y" = (
/mob/living/carbon/human/species/skeleton/npc/peasant,
/obj/structure/bed/rogue/mediocre,
/obj/item/reagent_containers/food/snacks/rogue/crackerscooked,
/obj/effect/decal/cleanable/blood/gibs/old,
/turf/open/floor/rogue/cobble,
/area/rogue)
"Z" = (
/obj/structure/table/wood/plain,
/obj/item/natural/cloth,
/obj/item/natural/cloth{
	pixel_y = 5;
	pixel_x = -7
	},
/turf/open/floor/rogue/cobble,
/area/rogue)

(1,1,1) = {"
y
y
y
y
y
l
P
y
y
y
y
y
"}
(2,1,1) = {"
y
A
J
W
r
P
l
y
T
x
a
y
"}
(3,1,1) = {"
y
Z
W
N
j
l
P
y
P
P
T
y
"}
(4,1,1) = {"
y
X
W
Y
y
P
l
y
u
z
K
y
"}
(5,1,1) = {"
y
y
r
y
y
l
P
j
r
j
y
y
"}
(6,1,1) = {"
P
l
l
P
P
l
P
P
E
l
l
P
"}
(7,1,1) = {"
P
P
P
l
P
P
l
P
l
l
P
P
"}
(8,1,1) = {"
y
y
y
y
y
P
l
j
y
y
y
y
"}
(9,1,1) = {"
y
w
b
v
j
P
P
r
i
U
e
y
"}
(10,1,1) = {"
y
G
C
C
r
l
P
y
g
V
i
y
"}
(11,1,1) = {"
y
c
v
C
y
l
P
y
i
g
f
y
"}
(12,1,1) = {"
y
y
y
y
y
l
l
y
y
y
y
y
"}

(1,1,2) = {"
y
y
y
y
P
P
P
P
y
y
y
y
"}
(2,1,2) = {"
y
L
m
y
y
l
l
y
y
B
R
y
"}
(3,1,2) = {"
y
q
h
l
y
P
P
y
l
l
m
y
"}
(4,1,2) = {"
y
y
S
l
P
P
l
P
p
B
y
y
"}
(5,1,2) = {"
P
y
y
P
h
H
h
P
k
y
y
l
"}
(6,1,2) = {"
l
l
P
l
P
h
Q
s
h
P
P
P
"}
(7,1,2) = {"
P
P
P
P
h
h
d
h
P
P
l
P
"}
(8,1,2) = {"
P
y
y
l
n
I
P
h
l
y
y
P
"}
(9,1,2) = {"
y
y
O
l
l
P
l
l
P
k
y
y
"}
(10,1,2) = {"
y
M
p
l
y
P
P
y
t
h
F
y
"}
(11,1,2) = {"
y
D
o
y
y
l
P
y
y
l
L
y
"}
(12,1,2) = {"
y
y
y
y
P
P
l
P
y
y
y
y
"}
