//MAP CONVERTED BY dmm2tgm.py THIS HEADER COMMENT PREVENTS RECONVERSION, DO NOT REMOVE
"aF" = (
/obj/structure/fluff/statue/evil,
/turf/open/floor/rogue/hexstone,
/area/rogue)
"aV" = (
/obj/structure/lever/wall{
	dir = 8;
	redstone_id = northgatematt
	},
/turf/open/floor/rogue/hexstone,
/area/rogue)
"aW" = (
/turf/closed/wall/mineral/rogue/stone/window,
/area/rogue)
"cX" = (
/obj/structure/fluff/railing/border,
/turf/open/floor/rogue/ruinedwood/spiral,
/area/rogue)
"du" = (
/obj/structure/fermenting_barrel/random/beer,
/turf/open/floor/rogue/ruinedwood/spiral,
/area/rogue)
"dY" = (
/obj/structure/table/church,
/obj/item/flashlight/flare/torch/metal{
	pixel_y = 7
	},
/obj/item/flashlight/flare/torch/metal{
	pixel_y = 6;
	pixel_x = -8
	},
/obj/item/flashlight/flare/torch/metal{
	pixel_x = 7;
	pixel_y = 6
	},
/turf/open/floor/carpet/red,
/area/rogue)
"el" = (
/obj/structure/mineral_door/wood/donjon/stone,
/turf/closed/wall/mineral/rogue/stone,
/area/rogue)
"er" = (
/obj/structure/fermenting_barrel,
/turf/open/floor/rogue/hexstone,
/area/rogue)
"eJ" = (
/obj/structure/rack/rogue/shelf/biggest,
/obj/item/reagent_containers/glass/cup/wooden{
	pixel_y = -7
	},
/obj/item/reagent_containers/glass/cup/wooden{
	pixel_x = -5;
	pixel_y = 12
	},
/obj/item/reagent_containers/glass/cup/wooden{
	pixel_x = 8;
	pixel_y = 10
	},
/turf/open/floor/rogue/ruinedwood/spiral,
/area/rogue)
"fr" = (
/obj/structure/roguetent,
/turf/open/floor/rogue/dirt,
/area/rogue)
"fL" = (
/turf/closed/wall/mineral/rogue/stone/window/moss,
/area/rogue)
"fM" = (
/obj/structure/fermenting_barrel/random/beer,
/turf/open/floor/rogue/hexstone,
/area/rogue)
"gi" = (
/obj/structure/fluff/statue/knightalt/r,
/turf/open/floor/rogue/hexstone,
/area/rogue)
"gz" = (
/obj/structure/closet/crate/drawer/inn,
/turf/open/floor/rogue/ruinedwood/spiral,
/area/rogue)
"iu" = (
/obj/structure/stairs/stone/church{
	dir = 1
	},
/turf/open/floor/rogue/dirt,
/area/rogue)
"iH" = (
/obj/structure/bars,
/turf/open/floor/rogue/hexstone,
/area/rogue)
"jN" = (
/obj/structure/wallladder{
	dir = 1
	},
/turf/open/floor/rogue/dirt,
/area/rogue)
"jS" = (
/obj/structure/stairs/stone/church{
	dir = 4
	},
/turf/open/floor/rogue/ruinedwood/spiral,
/area/rogue)
"jX" = (
/obj/machinery/light/rogue/firebowl,
/turf/open/floor/rogue/hexstone,
/area/rogue)
"kn" = (
/obj/machinery/light/rogue/firebowl,
/turf/open/floor/rogue/ruinedwood/spiral,
/area/rogue)
"kN" = (
/obj/structure/mineral_door/wood/deadbolt{
	dir = 4
	},
/turf/open/floor/rogue/ruinedwood/spiral,
/area/rogue)
"kT" = (
/turf/closed/mineral/rogue/bedrock,
/area/rogue)
"lW" = (
/obj/structure/fluff/railing/border{
	dir = 1
	},
/turf/open/floor/rogue/ruinedwood/spiral,
/area/rogue)
"mA" = (
/obj/structure/wallladder{
	dir = 4
	},
/turf/open/floor/rogue/dirt,
/area/rogue)
"mV" = (
/obj/structure/table/wood/reinf_long,
/obj/structure/bars/alt,
/turf/open/floor/rogue/ruinedwood/spiral,
/area/rogue)
"nA" = (
/obj/structure/fluff/railing/border{
	dir = 4
	},
/turf/open/floor/rogue/ruinedwood/spiral,
/area/rogue)
"oj" = (
/obj/structure/stairs/stone/church{
	dir = 1
	},
/turf/open/floor/rogue/ruinedwood/spiral,
/area/rogue)
"oB" = (
/obj/structure/table/wood/reinforced_alter,
/obj/structure/bars/alt,
/turf/open/floor/rogue/ruinedwood/spiral,
/area/rogue)
"pm" = (
/obj/structure/bed/rogue/hay,
/turf/open/floor/rogue/hexstone,
/area/rogue)
"qo" = (
/obj/structure/chair/stool/rogue,
/turf/open/floor/rogue/naturalstone,
/area/rogue)
"qX" = (
/obj/structure/mineral_door/wood/donjon/stone,
/turf/open/floor/rogue/hexstone,
/area/rogue)
"sQ" = (
/obj/machinery/light/rogue/torchholder/r,
/turf/open/floor/rogue/hexstone,
/area/rogue)
"uj" = (
/obj/structure/fluff/traveltile,
/turf/open/floor/rogue/ruinedwood/spiral,
/area/rogue)
"uO" = (
/obj/structure/closet/crate/roguecloset/inn/south,
/turf/open/floor/rogue/ruinedwood/spiral,
/area/rogue)
"wx" = (
/obj/machinery/light/rogue/campfire/longlived,
/turf/open/floor/rogue/naturalstone,
/area/rogue)
"xm" = (
/obj/structure/table/wood/plain/alt,
/turf/open/floor/rogue/ruinedwood/spiral,
/area/rogue)
"yg" = (
/turf/closed/wall/mineral/rogue/tent,
/area/rogue)
"yr" = (
/turf/open/transparent/openspace,
/area/rogue)
"AR" = (
/turf/closed/wall/mineral/rogue/stone,
/area/rogue)
"Bz" = (
/turf/open/floor/carpet/red,
/area/rogue)
"CE" = (
/turf/closed/wall/mineral/rogue/stone/moss,
/area/rogue)
"Di" = (
/obj/structure/fluff/statue/knight/interior,
/turf/open/floor/rogue/naturalstone,
/area/rogue)
"DK" = (
/obj/structure/fluff/railing/border{
	dir = 8
	},
/obj/structure/fluff/railing/border{
	dir = 8
	},
/turf/open/floor/rogue/ruinedwood/spiral,
/area/rogue)
"DY" = (
/obj/structure/fermenting_barrel/random/water,
/turf/open/floor/rogue/ruinedwood/spiral,
/area/rogue)
"Fo" = (
/obj/structure/rack/rogue/shelf/biggest,
/turf/open/floor/rogue/ruinedwood/spiral,
/area/rogue)
"Gx" = (
/turf/open/floor/rogue/hexstone,
/area/rogue)
"GF" = (
/obj/structure/table/wood/plain/alt,
/turf/open/floor/rogue/hexstone,
/area/rogue)
"Hc" = (
/obj/structure/wallladder{
	dir = 1
	},
/turf/open/floor/rogue/naturalstone,
/area/rogue)
"Hq" = (
/obj/item/chair/stool/bar/rogue/crafted,
/turf/open/floor/rogue/naturalstone,
/area/rogue)
"Io" = (
/obj/structure/fluff/railing/border,
/obj/structure/table/wood/plain/alt,
/obj/item/reagent_containers/glass/cup/skull,
/turf/open/floor/rogue/ruinedwood/spiral,
/area/rogue)
"Iv" = (
/obj/structure/fluff/railing/border,
/obj/structure/chair/stool/rogue,
/turf/open/floor/rogue/ruinedwood/spiral,
/area/rogue)
"Jv" = (
/obj/structure/chair/stool/rogue,
/turf/open/floor/rogue/dirt,
/area/rogue)
"Kk" = (
/turf/open/floor/rogue/naturalstone,
/area/rogue)
"Lj" = (
/obj/structure/fluff/statue/knight/interior/r,
/turf/open/floor/rogue/naturalstone,
/area/rogue)
"Lo" = (
/obj/structure/bed/rogue/shit,
/turf/open/floor/rogue/naturalstone,
/area/rogue)
"LJ" = (
/turf/closed/wall/mineral/rogue/wooddark,
/area/rogue)
"LT" = (
/obj/structure/gate{
	redstone_id = northgatematt
	},
/turf/open/floor/rogue/hexstone,
/area/rogue)
"Ob" = (
/turf/open/floor/rogue/ruinedwood/spiral,
/area/rogue)
"OM" = (
/obj/structure/fluff/railing/border{
	dir = 8
	},
/turf/open/floor/rogue/ruinedwood/spiral,
/area/rogue)
"OS" = (
/obj/machinery/light/rogue/torchholder/r,
/turf/open/floor/rogue/ruinedwood/spiral,
/area/rogue)
"PL" = (
/obj/structure/table/church/m,
/obj/item/reagent_containers/glass/bottle/waterskin{
	pixel_y = -1;
	pixel_x = -5
	},
/obj/item/reagent_containers/glass/bottle/waterskin{
	pixel_y = 3
	},
/obj/item/reagent_containers/glass/bottle/waterskin{
	pixel_x = 8;
	pixel_y = 7
	},
/turf/open/floor/carpet/red,
/area/rogue)
"Qn" = (
/obj/structure/roguetent,
/turf/open/floor/rogue/naturalstone,
/area/rogue)
"RE" = (
/obj/structure/stairs/stone/church{
	dir = 4
	},
/turf/open/floor/rogue/naturalstone,
/area/rogue)
"RI" = (
/obj/structure/mineral_door/wood/deadbolt,
/turf/open/floor/rogue/ruinedwood/spiral,
/area/rogue)
"RR" = (
/obj/structure/fermenting_barrel/random/water,
/turf/open/floor/rogue/hexstone,
/area/rogue)
"SG" = (
/turf/open/floor/rogue/dirt,
/area/rogue)
"Ti" = (
/obj/structure/fluff/statue/knightalt,
/turf/open/floor/rogue/hexstone,
/area/rogue)
"Tq" = (
/obj/structure/chair/stool/rogue,
/turf/open/floor/rogue/ruinedwood/spiral,
/area/rogue)
"TK" = (
/obj/structure/bed/rogue/inn,
/turf/open/floor/rogue/ruinedwood/spiral,
/area/rogue)
"Vm" = (
/obj/machinery/light/rogue/torchholder/l,
/turf/open/floor/rogue/hexstone,
/area/rogue)
"Wd" = (
/obj/structure/table/wood/plain/alt,
/obj/machinery/light/rogue/torchholder/r,
/turf/open/floor/rogue/hexstone,
/area/rogue)
"Wl" = (
/obj/structure/table/wood/reinf_long{
	dir = 1
	},
/obj/structure/bars/alt,
/turf/open/floor/rogue/ruinedwood/spiral,
/area/rogue)
"Yp" = (
/obj/item/chair/stool/bar/rogue/crafted,
/turf/open/floor/rogue/ruinedwood/spiral,
/area/rogue)
"Yx" = (
/obj/structure/table/church{
	dir = 1
	},
/obj/item/reagent_containers/food/snacks/rogue/crackerscooked{
	pixel_x = 8;
	pixel_y = 12
	},
/obj/item/reagent_containers/food/snacks/rogue/crackerscooked{
	pixel_x = 2;
	pixel_y = 4
	},
/obj/item/reagent_containers/food/snacks/rogue/crackerscooked{
	pixel_x = -7;
	pixel_y = 11
	},
/turf/open/floor/carpet/red,
/area/rogue)

(1,1,1) = {"
kT
kT
kT
kT
kT
kT
kT
kT
kT
kT
kT
kT
kT
Kk
Kk
Kk
LJ
Gx
Gx
LJ
SG
kT
kT
kT
kT
"}
(2,1,1) = {"
kT
kT
kT
kT
kT
kT
kT
kT
kT
kT
kT
kT
kT
SG
SG
Kk
LJ
Gx
Gx
LJ
jN
kT
kT
kT
kT
"}
(3,1,1) = {"
kT
kT
kT
kT
kT
kT
kT
kT
kT
kT
kT
kT
kT
SG
SG
Kk
SG
Gx
Gx
SG
SG
kT
kT
kT
kT
"}
(4,1,1) = {"
kT
kT
kT
kT
kT
kT
kT
kT
kT
kT
kT
kT
Kk
Kk
Kk
Kk
SG
Gx
Gx
SG
SG
kT
kT
kT
kT
"}
(5,1,1) = {"
kT
kT
kT
kT
kT
kT
kT
kT
kT
kT
kT
Kk
yg
yg
yg
SG
SG
Gx
Gx
SG
SG
SG
SG
SG
kT
"}
(6,1,1) = {"
kT
kT
kT
kT
kT
kT
kT
kT
kT
kT
Kk
Kk
yg
Lo
fr
Kk
SG
Gx
Gx
SG
SG
kT
Kk
kT
kT
"}
(7,1,1) = {"
kT
kT
kT
kT
kT
kT
kT
kT
kT
kT
kT
Kk
yg
yg
yg
Kk
SG
Gx
Gx
SG
Kk
kT
Kk
kT
kT
"}
(8,1,1) = {"
kT
kT
kT
kT
kT
kT
kT
kT
kT
kT
kT
Kk
Kk
Kk
SG
Kk
SG
Gx
Gx
SG
SG
kT
kT
kT
kT
"}
(9,1,1) = {"
kT
kT
kT
kT
kT
kT
kT
kT
kT
kT
Kk
SG
yg
yg
yg
SG
SG
Gx
Gx
SG
Kk
Kk
Kk
kT
kT
"}
(10,1,1) = {"
kT
kT
kT
kT
kT
kT
kT
kT
kT
kT
Kk
Kk
yg
Lo
Qn
Kk
SG
Gx
Gx
SG
SG
kT
SG
kT
kT
"}
(11,1,1) = {"
kT
kT
kT
kT
kT
kT
kT
kT
Kk
Hq
Kk
Kk
yg
yg
yg
Kk
SG
Gx
Gx
SG
SG
kT
Kk
Kk
kT
"}
(12,1,1) = {"
kT
kT
kT
kT
kT
kT
kT
Kk
Kk
Kk
Kk
SG
SG
SG
Kk
SG
SG
Gx
Gx
SG
SG
kT
kT
Kk
kT
"}
(13,1,1) = {"
kT
kT
kT
kT
kT
kT
Kk
Kk
RE
RE
Kk
Kk
Kk
Kk
Kk
Kk
SG
Gx
Gx
SG
SG
Kk
kT
kT
kT
"}
(14,1,1) = {"
kT
kT
kT
kT
AR
CE
CE
CE
AR
AR
CE
CE
CE
SG
SG
Kk
SG
Gx
Gx
SG
SG
Kk
kT
kT
kT
"}
(15,1,1) = {"
kT
kT
kT
kT
AR
Vm
Gx
Gx
Gx
Vm
Gx
Gx
AR
Kk
SG
SG
SG
Gx
Gx
SG
SG
Kk
Kk
kT
kT
"}
(16,1,1) = {"
kT
kT
kT
kT
CE
Gx
Gx
Gx
Gx
Gx
Gx
Gx
CE
Kk
SG
SG
SG
Gx
Gx
SG
SG
SG
SG
Kk
kT
"}
(17,1,1) = {"
kT
kT
kT
kT
CE
Wd
pm
GF
pm
Wd
pm
Gx
CE
Kk
SG
SG
SG
Gx
Gx
SG
SG
Kk
Kk
Kk
Kk
"}
(18,1,1) = {"
kT
kT
kT
kT
AR
AR
CE
CE
AR
CE
AR
el
CE
CE
CE
CE
SG
Gx
Gx
SG
Kk
Kk
SG
Kk
Kk
"}
(19,1,1) = {"
kT
kT
kT
kT
CE
jX
Gx
Gx
Gx
Gx
Gx
Gx
CE
aV
Gx
AR
iu
Gx
Gx
SG
Kk
Kk
SG
Kk
Kk
"}
(20,1,1) = {"
kT
kT
kT
kT
AR
Gx
Gx
Gx
Gx
Gx
Gx
Gx
qX
Gx
Gx
CE
iu
Gx
Gx
SG
SG
SG
SG
mA
SG
"}
(21,1,1) = {"
kT
kT
kT
kT
CE
Gx
Gx
Gx
Gx
Gx
Gx
Gx
CE
iH
iH
CE
Di
Gx
Gx
SG
SG
SG
SG
LJ
LJ
"}
(22,1,1) = {"
kT
kT
kT
kT
CE
Ti
Bz
dY
Bz
Bz
Bz
Gx
LT
Gx
Gx
Vm
Gx
Gx
Gx
Gx
Gx
Gx
Gx
Gx
Gx
"}
(23,1,1) = {"
kT
kT
kT
kT
CE
aF
Bz
PL
Bz
Bz
Bz
Gx
Gx
Gx
Gx
Gx
Gx
Gx
Gx
Gx
Gx
Gx
Gx
Gx
Gx
"}
(24,1,1) = {"
kT
kT
kT
kT
CE
gi
Bz
Yx
Bz
Bz
Bz
Gx
Gx
Gx
Gx
sQ
Gx
Gx
Gx
Gx
Gx
Gx
Gx
Gx
Gx
"}
(25,1,1) = {"
kT
kT
kT
kT
AR
Gx
Gx
Gx
Gx
Gx
Gx
Gx
CE
iH
iH
CE
Lj
Gx
Gx
SG
SG
SG
SG
LJ
LJ
"}
(26,1,1) = {"
kT
kT
kT
kT
AR
Gx
Gx
Gx
Gx
Gx
Gx
Gx
qX
Gx
Gx
AR
SG
Gx
Gx
SG
Kk
Kk
Kk
Kk
Kk
"}
(27,1,1) = {"
kT
kT
kT
kT
CE
jX
Gx
Gx
Gx
Gx
Gx
Gx
AR
Gx
Gx
CE
SG
Gx
Gx
SG
Kk
SG
SG
SG
Kk
"}
(28,1,1) = {"
kT
kT
kT
kT
CE
AR
CE
CE
CE
CE
AR
el
CE
CE
CE
CE
SG
Gx
Gx
SG
Kk
Kk
SG
Kk
Kk
"}
(29,1,1) = {"
kT
kT
kT
kT
AR
RR
RR
RR
RR
Gx
Gx
Gx
CE
Kk
Kk
Kk
SG
Gx
Gx
SG
SG
SG
Kk
kT
kT
"}
(30,1,1) = {"
kT
kT
kT
kT
AR
Gx
Gx
Gx
Gx
Gx
Gx
Gx
CE
yg
yg
yg
SG
Gx
Gx
SG
SG
SG
kT
Kk
kT
"}
(31,1,1) = {"
kT
kT
kT
kT
AR
fM
er
er
fM
Gx
Gx
Gx
AR
yg
Lo
yg
SG
Gx
Gx
SG
Kk
Kk
Kk
SG
kT
"}
(32,1,1) = {"
kT
kT
kT
kT
AR
CE
CE
AR
CE
CE
AR
CE
CE
yg
Qn
yg
SG
Gx
Gx
SG
Kk
kT
kT
Kk
kT
"}
(33,1,1) = {"
kT
kT
kT
kT
kT
kT
kT
Kk
yg
yg
yg
SG
Kk
qo
Kk
Kk
SG
Gx
Gx
SG
Kk
Kk
Kk
SG
kT
"}
(34,1,1) = {"
kT
kT
kT
kT
kT
kT
kT
Kk
yg
Lo
Qn
SG
Jv
wx
Kk
SG
SG
Gx
Gx
SG
SG
Kk
SG
kT
kT
"}
(35,1,1) = {"
kT
kT
kT
kT
kT
kT
kT
kT
yg
yg
yg
Kk
Kk
Kk
qo
Kk
SG
Gx
Gx
SG
Kk
Kk
Kk
Kk
kT
"}
(36,1,1) = {"
kT
kT
kT
kT
kT
kT
kT
kT
kT
Kk
Kk
SG
yg
Qn
yg
Kk
SG
Gx
Gx
SG
Kk
kT
kT
kT
kT
"}
(37,1,1) = {"
kT
kT
kT
kT
kT
kT
kT
kT
kT
kT
Kk
Kk
yg
Lo
yg
Kk
SG
Gx
Gx
SG
Kk
kT
kT
kT
kT
"}
(38,1,1) = {"
kT
kT
kT
kT
kT
kT
kT
kT
kT
kT
Kk
Kk
yg
yg
yg
Kk
SG
Gx
Gx
SG
Kk
kT
kT
kT
kT
"}
(39,1,1) = {"
kT
kT
kT
kT
kT
kT
kT
kT
kT
kT
kT
Kk
Kk
Kk
Kk
SG
SG
Gx
Gx
SG
Kk
kT
kT
kT
kT
"}
(40,1,1) = {"
kT
kT
kT
kT
kT
kT
kT
kT
kT
kT
kT
Kk
SG
SG
Kk
Kk
SG
Gx
Gx
SG
Kk
kT
kT
kT
kT
"}
(41,1,1) = {"
kT
kT
kT
kT
kT
kT
kT
kT
kT
kT
kT
kT
Kk
SG
SG
SG
SG
Gx
Gx
SG
Kk
kT
kT
kT
kT
"}
(42,1,1) = {"
kT
kT
kT
kT
kT
kT
kT
kT
kT
kT
kT
kT
Kk
Kk
SG
Kk
SG
Gx
Gx
SG
Kk
kT
kT
kT
kT
"}
(43,1,1) = {"
kT
kT
kT
kT
kT
kT
kT
kT
kT
kT
kT
kT
kT
Kk
Kk
Kk
SG
Gx
Gx
SG
Kk
kT
kT
kT
kT
"}
(44,1,1) = {"
kT
kT
kT
kT
kT
kT
kT
kT
kT
kT
kT
kT
kT
SG
SG
Kk
LJ
Gx
Gx
LJ
Hc
kT
kT
kT
kT
"}
(45,1,1) = {"
kT
kT
kT
kT
kT
kT
kT
kT
kT
kT
kT
kT
kT
SG
SG
SG
LJ
Gx
Gx
LJ
Kk
kT
kT
kT
kT
"}

(1,1,2) = {"
kT
kT
kT
kT
kT
kT
kT
kT
kT
kT
kT
kT
kT
yr
yr
yr
Ob
Ob
Ob
Ob
yr
kT
kT
kT
kT
"}
(2,1,2) = {"
kT
kT
kT
kT
kT
kT
kT
kT
kT
kT
kT
kT
kT
yr
yr
yr
nA
nA
nA
nA
yr
kT
kT
kT
kT
"}
(3,1,2) = {"
kT
kT
kT
kT
kT
kT
kT
kT
kT
kT
kT
kT
kT
yr
yr
yr
yr
yr
yr
yr
yr
kT
kT
kT
kT
"}
(4,1,2) = {"
kT
kT
kT
kT
kT
kT
kT
kT
kT
kT
kT
kT
yr
yr
yr
yr
yr
yr
yr
yr
yr
kT
kT
kT
kT
"}
(5,1,2) = {"
kT
kT
kT
kT
kT
kT
kT
kT
kT
kT
kT
yr
yg
yg
yg
yr
yr
yr
yr
yr
yr
yr
yr
yr
kT
"}
(6,1,2) = {"
kT
kT
kT
kT
kT
kT
kT
kT
kT
kT
yr
yr
yg
yg
yg
yr
yr
yr
yr
yr
yr
kT
yr
kT
kT
"}
(7,1,2) = {"
kT
kT
kT
kT
kT
kT
kT
kT
kT
kT
kT
yr
yg
yg
yg
yr
yr
yr
yr
yr
yr
kT
yr
kT
kT
"}
(8,1,2) = {"
kT
kT
kT
kT
kT
kT
kT
kT
kT
kT
kT
yr
yr
yr
yr
yr
yr
yr
yr
yr
yr
kT
kT
kT
kT
"}
(9,1,2) = {"
kT
kT
kT
kT
kT
kT
kT
kT
kT
kT
yr
yr
yg
yg
yg
yr
yr
yr
yr
yr
yr
yr
yr
kT
kT
"}
(10,1,2) = {"
kT
kT
kT
kT
kT
kT
kT
kT
kT
kT
yr
yr
yg
yg
yg
yr
yr
yr
yr
yr
yr
kT
kT
kT
kT
"}
(11,1,2) = {"
kT
kT
kT
kT
kT
kT
kT
kT
kT
kT
yr
yr
yg
yg
yg
yr
yr
yr
yr
yr
yr
kT
kT
kT
kT
"}
(12,1,2) = {"
kT
kT
kT
kT
kT
kT
kT
yr
yr
yr
yr
yr
yr
yr
yr
yr
yr
yr
yr
yr
yr
kT
kT
kT
kT
"}
(13,1,2) = {"
kT
kT
kT
kT
kT
kT
yr
yr
yr
yr
yr
yr
yr
yr
yr
yr
yr
yr
yr
yr
yr
yr
kT
kT
kT
"}
(14,1,2) = {"
AR
AR
AR
AR
AR
kT
aW
AR
jS
jS
AR
AR
AR
OM
OM
AR
yr
yr
yr
yr
yr
yr
kT
kT
kT
"}
(15,1,2) = {"
AR
Ob
kn
Ob
Tq
Ob
Ob
Ob
Ob
Ob
Tq
Ob
Ob
Ob
Ob
Iv
yr
yr
yr
yr
yr
yr
kT
kT
kT
"}
(16,1,2) = {"
AR
Ob
Ob
Ob
xm
Ob
Ob
Ob
Ob
Ob
xm
Ob
Ob
Ob
Ob
Io
yr
yr
yr
yr
yr
yr
yr
yr
kT
"}
(17,1,2) = {"
AR
Ob
Ob
Ob
Yp
Ob
Tq
Ob
Ob
Ob
Ob
Ob
kn
Ob
Ob
Iv
yr
yr
yr
yr
yr
yr
yr
yr
yr
"}
(18,1,2) = {"
AR
Ob
Ob
Ob
Ob
Ob
xm
Ob
Ob
Ob
Ob
Ob
AR
AR
AR
AR
yr
yr
yr
yr
yr
yr
yr
yr
yr
"}
(19,1,2) = {"
AR
Ob
Ob
Ob
Tq
Ob
Tq
Ob
Ob
xm
Ob
Ob
Ob
Ob
Ob
oj
yr
yr
yr
yr
yr
yr
yr
yr
yr
"}
(20,1,2) = {"
AR
Ob
Ob
Ob
xm
Ob
Ob
Tq
Ob
Tq
Ob
Ob
Ob
Ob
Ob
oj
yr
yr
yr
yr
yr
yr
yr
yr
yr
"}
(21,1,2) = {"
uj
uj
Ob
Ob
Ob
Ob
Ob
xm
Ob
Ob
Yp
Ob
AR
aW
AR
AR
yr
yr
yr
yr
yr
yr
yr
lW
Ob
"}
(22,1,2) = {"
uj
uj
Ob
Ob
Ob
Ob
Ob
Ob
Ob
Ob
Ob
Ob
cX
yr
yr
yr
yr
yr
yr
yr
yr
yr
yr
lW
Ob
"}
(23,1,2) = {"
uj
uj
Ob
Ob
Ob
Ob
Ob
Ob
kn
Ob
Ob
Ob
cX
yr
yr
yr
yr
yr
yr
yr
yr
yr
yr
lW
Ob
"}
(24,1,2) = {"
uj
uj
Ob
Ob
Ob
Ob
Ob
Ob
Ob
Ob
Ob
Ob
cX
yr
yr
yr
yr
yr
yr
yr
yr
yr
yr
lW
Ob
"}
(25,1,2) = {"
uj
uj
Ob
Wl
oB
oB
oB
oB
oB
oB
oB
mV
AR
aW
AR
AR
yr
yr
yr
yr
yr
yr
yr
lW
Ob
"}
(26,1,2) = {"
AR
Ob
Ob
AR
Ob
Ob
Ob
Ob
Ob
Ob
Ob
Ob
Ob
Ob
Fo
AR
yr
yr
yr
yr
yr
yr
yr
yr
yr
"}
(27,1,2) = {"
AR
Ob
Ob
RI
OS
Fo
Fo
Ob
OS
Fo
Fo
Fo
Fo
OS
Fo
AR
yr
yr
yr
yr
yr
yr
yr
yr
yr
"}
(28,1,2) = {"
AR
Ob
Ob
AR
AR
AR
AR
kN
AR
AR
AR
AR
AR
AR
AR
AR
yr
yr
yr
yr
yr
yr
yr
yr
yr
"}
(29,1,2) = {"
AR
Ob
Ob
AR
TK
Ob
Ob
Ob
AR
eJ
Fo
Fo
fL
yr
yr
yr
yr
yr
yr
yr
yr
yr
yr
kT
kT
"}
(30,1,2) = {"
AR
Ob
Ob
AR
gz
Ob
Ob
Ob
RI
Ob
Ob
Ob
fL
yg
yg
yg
yr
yr
yr
yr
yr
yr
kT
yr
kT
"}
(31,1,2) = {"
AR
Ob
Ob
AR
uO
Ob
Ob
Ob
aW
du
DY
DY
fL
yg
yg
yg
yr
yr
yr
yr
yr
yr
kT
yr
kT
"}
(32,1,2) = {"
AR
AR
AR
AR
AR
AR
AR
AR
aW
AR
AR
AR
AR
yg
yr
yg
yr
yr
yr
yr
yr
kT
kT
yr
kT
"}
(33,1,2) = {"
kT
kT
kT
kT
kT
kT
kT
yr
yg
yg
yg
yr
yr
yr
yr
yr
yr
yr
yr
yr
yr
yr
yr
yr
kT
"}
(34,1,2) = {"
kT
kT
kT
kT
kT
kT
kT
yr
yg
yg
yr
yr
yr
yr
yr
yr
yr
yr
yr
yr
yr
yr
yr
kT
kT
"}
(35,1,2) = {"
kT
kT
kT
kT
kT
kT
kT
kT
yg
yg
yg
yr
yr
yr
yr
yr
yr
yr
yr
yr
yr
yr
yr
yr
kT
"}
(36,1,2) = {"
kT
kT
kT
kT
kT
kT
kT
kT
kT
yr
yr
yr
yg
yr
yg
yr
yr
yr
yr
yr
yr
kT
kT
kT
kT
"}
(37,1,2) = {"
kT
kT
kT
kT
kT
kT
kT
kT
kT
kT
yr
yr
yg
yg
yg
yr
yr
yr
yr
yr
yr
kT
kT
kT
kT
"}
(38,1,2) = {"
kT
kT
kT
kT
kT
kT
kT
kT
kT
kT
yr
yr
yg
yg
yg
yr
yr
yr
yr
yr
yr
kT
kT
kT
kT
"}
(39,1,2) = {"
kT
kT
kT
kT
kT
kT
kT
kT
kT
kT
kT
yr
yr
yr
yr
yr
yr
yr
yr
yr
yr
kT
kT
kT
kT
"}
(40,1,2) = {"
kT
kT
kT
kT
kT
kT
kT
kT
kT
kT
kT
yr
yr
yr
yr
yr
yr
yr
yr
yr
yr
kT
kT
kT
kT
"}
(41,1,2) = {"
kT
kT
kT
kT
kT
kT
kT
kT
kT
kT
kT
kT
yr
yr
yr
yr
yr
yr
yr
yr
yr
kT
kT
kT
kT
"}
(42,1,2) = {"
kT
kT
kT
kT
kT
kT
kT
kT
kT
kT
kT
kT
yr
yr
yr
yr
yr
yr
yr
yr
yr
kT
kT
kT
kT
"}
(43,1,2) = {"
kT
kT
kT
kT
kT
kT
kT
kT
kT
kT
kT
kT
kT
yr
yr
yr
yr
yr
yr
yr
yr
kT
kT
kT
kT
"}
(44,1,2) = {"
kT
kT
kT
kT
kT
kT
kT
kT
kT
kT
kT
kT
kT
yr
yr
yr
OM
OM
DK
OM
yr
kT
kT
kT
kT
"}
(45,1,2) = {"
kT
kT
kT
kT
kT
kT
kT
kT
kT
kT
kT
kT
kT
yr
yr
yr
Ob
Ob
Ob
Ob
yr
kT
kT
kT
kT
"}
