//MAP CONVERTED BY dmm2tgm.py THIS HEADER COMMENT PREVENTS RECONVERSION, DO NOT REMOVE
"aS" = (
/obj/structure/chair/stool/rogue,
/mob/living/simple_animal/hostile/rogue/orc/orc2,
/turf/open/floor/rogue/dirt,
/area/rogue)
"bp" = (
/turf/closed/wall/mineral/rogue/stonebrick,
/area/rogue)
"bI" = (
/obj/structure/fermenting_barrel/random/beer,
/turf/open/floor/rogue/dirt,
/area/rogue)
"da" = (
/obj/structure/mineral_door/wood/donjon/stone,
/turf/open/floor/rogue/dirt,
/area/rogue)
"di" = (
/obj/structure/fluff/railing/border{
	dir = 6
	},
/turf/open/floor/rogue/ruinedwood/spiral,
/area/rogue)
"em" = (
/obj/item/chair/stool/bar/rogue,
/turf/open/floor/rogue/ruinedwood/spiral,
/area/rogue)
"eK" = (
/obj/machinery/light/rogue/campfire/longlived,
/turf/open/floor/rogue/dirt,
/area/rogue)
"gd" = (
/obj/structure/fluff/railing/border,
/turf/open/floor/rogue/ruinedwood/spiral,
/area/rogue)
"gz" = (
/obj/structure/chair/stool/rogue,
/turf/open/floor/rogue/ruinedwood/spiral,
/area/rogue)
"jT" = (
/turf/open/floor/rogue/dirt/road,
/area/rogue)
"ln" = (
/obj/structure/chair/stool/rogue,
/mob/living/simple_animal/hostile/rogue/orc/spear,
/turf/open/floor/rogue/dirt,
/area/rogue)
"ly" = (
/obj/item/clothing/shoes/roguetown/nobleboot{
	pixel_x = 1;
	pixel_y = 15
	},
/turf/open/floor/rogue/ruinedwood/spiral,
/area/rogue)
"lI" = (
/obj/machinery/light/rogue/wallfire,
/turf/closed/wall/mineral/rogue/wooddark/horizontal,
/area/rogue)
"mb" = (
/obj/structure/chair/stool/rogue,
/mob/living/simple_animal/hostile/rogue/orc/ranged,
/turf/open/floor/rogue/dirt,
/area/rogue)
"pH" = (
/turf/open/floor/rogue/dirt,
/area/rogue)
"pQ" = (
/obj/structure/table/wood/counter/end{
	dir = 1
	},
/obj/item/clothing/neck/roguetown/menears,
/turf/open/floor/rogue/ruinedwood/spiral,
/area/rogue)
"pT" = (
/turf/open/floor/rogue/ruinedwood/spiral,
/area/rogue)
"qE" = (
/obj/structure/toilet,
/obj/item/clothing/neck/roguetown/psycross/g,
/obj/item/natural/poo{
	pixel_y = 9
	},
/obj/item/natural/poo{
	pixel_y = -4;
	pixel_x = 6
	},
/obj/item/natural/poo{
	pixel_x = -4
	},
/mob/living/simple_animal/hostile/rogue/orc/orc2,
/turf/open/floor/rogue/dirt,
/area/rogue)
"rP" = (
/obj/machinery/light/rogue/firebowl,
/turf/open/floor/rogue/dirt,
/area/rogue)
"rQ" = (
/turf/closed/wall/mineral/rogue/tent,
/area/rogue)
"rV" = (
/turf/closed/wall/mineral/rogue/wooddark/horizontal,
/area/rogue)
"so" = (
/obj/structure/chair/stool/rogue,
/mob/living/simple_animal/hostile/rogue/orc/orc_marauder/spear,
/turf/open/floor/rogue/ruinedwood/spiral,
/area/rogue)
"sw" = (
/obj/structure/chair/bench/throne,
/mob/living/simple_animal/hostile/rogue/orc/orc_marauder/ravager,
/turf/open/floor/rogue/ruinedwood/spiral,
/area/rogue)
"tn" = (
/mob/living/simple_animal/hostile/rogue/orc/orc_marauder,
/turf/open/floor/rogue/ruinedwood/spiral,
/area/rogue)
"uj" = (
/obj/structure/roguetent,
/turf/open/floor/rogue/dirt/road,
/area/rogue)
"vg" = (
/turf/open/transparent/openspace,
/area/rogue)
"vm" = (
/obj/structure/chair/stool/rogue,
/mob/living/simple_animal/hostile/rogue/orc/spear2,
/turf/open/floor/rogue/ruinedwood/spiral,
/area/rogue)
"yp" = (
/mob/living/simple_animal/hostile/rogue/orc/orc_marauder/ravager,
/turf/open/floor/rogue/ruinedwood/spiral,
/area/rogue)
"yJ" = (
/obj/structure/roguewindow/openclose,
/turf/closed/wall/mineral/rogue/wooddark/vertical,
/area/rogue)
"zV" = (
/obj/structure/closet/dirthole/grave,
/turf/open/floor/rogue/dirt,
/area/rogue)
"CT" = (
/obj/structure/roguetent,
/turf/open/floor/rogue/dirt,
/area/rogue)
"Dh" = (
/obj/structure/ladder,
/turf/open/floor/rogue/naturalstone,
/area/rogue)
"FM" = (
/obj/item/rogueweapon/shovel,
/turf/open/floor/rogue/dirt,
/area/rogue)
"GK" = (
/obj/structure/ladder,
/turf/open/floor/rogue/dirt,
/area/rogue)
"HF" = (
/obj/structure/closet/dirthole/closed/loot,
/turf/open/floor/rogue/dirt,
/area/rogue)
"Jl" = (
/obj/item/clothing/ring/active/nomag,
/obj/structure/table/wood/counter/end,
/turf/open/floor/rogue/ruinedwood/spiral,
/area/rogue)
"Jt" = (
/obj/structure/bed/rogue/shit,
/mob/living/simple_animal/hostile/rogue/orc,
/turf/open/floor/rogue/dirt,
/area/rogue)
"JC" = (
/obj/structure/table/vtable/v2,
/obj/item/roguegem/random,
/obj/item/roguegem/random{
	pixel_x = -16;
	pixel_y = 6
	},
/obj/item/roguegem/random{
	pixel_y = 8;
	pixel_x = 6
	},
/turf/open/floor/rogue/ruinedwood/spiral,
/area/rogue)
"JV" = (
/obj/structure/table/wood/reinf_long{
	dir = 1
	},
/obj/item/clothing/mask/cigarette/rollie{
	pixel_y = -15
	},
/obj/item/clothing/mask/rogue/skullmask{
	pixel_y = 4;
	pixel_x = 1
	},
/turf/open/floor/rogue/ruinedwood/spiral,
/area/rogue)
"KK" = (
/obj/structure/table/vtable,
/obj/item/roguegem/diamond,
/obj/item/roguegem/blue{
	pixel_y = 13
	},
/obj/item/roguegem{
	pixel_x = -9;
	pixel_y = 9
	},
/obj/item/roguegem/green{
	pixel_y = 12;
	pixel_x = 11
	},
/obj/item/roguegem/yellow{
	pixel_x = -9
	},
/obj/item/roguegem/violet{
	pixel_x = 6
	},
/turf/open/floor/rogue/ruinedwood/spiral,
/area/rogue)
"Lh" = (
/obj/structure/fluff/railing/border{
	dir = 5
	},
/turf/open/floor/rogue/ruinedwood/spiral,
/area/rogue)
"Lw" = (
/turf/closed/wall/mineral/rogue/wooddark/vertical,
/area/rogue)
"Na" = (
/obj/structure/fluff/railing/border{
	dir = 4
	},
/turf/open/floor/rogue/ruinedwood/spiral,
/area/rogue)
"Nk" = (
/obj/structure/closet/crate/chest/wicker,
/obj/item/clothing/head/roguetown/fancyhat,
/obj/item/clothing/shoes/roguetown/nobleboot{
	pixel_x = -3;
	pixel_y = 8
	},
/obj/item/clothing/cloak/half/random,
/obj/item/clothing/suit/roguetown/armor/leather/vest/black,
/turf/open/floor/rogue/ruinedwood/spiral,
/area/rogue)
"Ns" = (
/obj/item/clothing/neck/roguetown/elfears,
/obj/structure/table/wood/large/corner,
/turf/open/floor/rogue/ruinedwood/spiral,
/area/rogue)
"Qq" = (
/turf/closed/mineral/rogue/bedrock,
/area/rogue)
"Sx" = (
/obj/structure/stairs,
/obj/structure/stairs,
/obj/structure/stairs,
/turf/open/floor/rogue/ruinedwood/spiral,
/area/rogue)
"SG" = (
/obj/structure/table/wood/reinf_long,
/obj/item/clothing/mask/rogue/shepherd/clothmask{
	pixel_x = 10
	},
/obj/item/flint{
	pixel_y = 4;
	pixel_x = -6
	},
/turf/open/floor/rogue/ruinedwood/spiral,
/area/rogue)
"TJ" = (
/turf/open/floor/rogue/naturalstone,
/area/rogue)
"UA" = (
/obj/structure/table/wood/large/corner,
/turf/open/floor/rogue/ruinedwood/spiral,
/area/rogue)
"UN" = (
/obj/item/reagent_containers/glass/cup/skull{
	pixel_x = -9
	},
/obj/item/reagent_containers/glass/cup/wooden/crafted{
	pixel_y = -10;
	pixel_x = 11
	},
/obj/item/reagent_containers/glass/cup/wooden/crafted{
	pixel_y = 13;
	pixel_x = 12
	},
/turf/open/floor/rogue/dirt/road,
/area/rogue)
"Vq" = (
/obj/structure/fluff/railing/fence,
/turf/open/floor/rogue/dirt,
/area/rogue)
"VC" = (
/obj/structure/stairs,
/turf/open/transparent/openspace,
/area/rogue)
"YU" = (
/obj/structure/gate/bars/preopen,
/turf/open/floor/rogue/dirt/road,
/area/rogue)

(1,1,1) = {"
Qq
Qq
Qq
Qq
Qq
Qq
Qq
Qq
Qq
Qq
Qq
Qq
Qq
Qq
Qq
Qq
Qq
Qq
Qq
Qq
"}
(2,1,1) = {"
Qq
pH
pH
pH
pH
pH
pH
pH
Vq
pH
rQ
rQ
rQ
rQ
rQ
rQ
rQ
rQ
rQ
Qq
"}
(3,1,1) = {"
Qq
pH
HF
zV
HF
zV
HF
pH
Vq
pH
rQ
Jt
rQ
rQ
Jt
rQ
rQ
Jt
rQ
Qq
"}
(4,1,1) = {"
Qq
pH
pH
pH
FM
pH
pH
pH
Vq
pH
rQ
CT
rQ
rQ
CT
rQ
rQ
CT
rQ
Qq
"}
(5,1,1) = {"
Qq
pH
HF
zV
HF
HF
HF
pH
Vq
pH
pH
jT
jT
jT
jT
jT
jT
jT
jT
Qq
"}
(6,1,1) = {"
Qq
GK
pH
pH
pH
pH
pH
pH
Vq
pH
pH
pH
pH
jT
pH
mb
pH
jT
pH
Qq
"}
(7,1,1) = {"
Qq
pH
pH
pH
pH
pH
pH
pH
Vq
pH
pH
pH
pH
jT
aS
eK
mb
jT
pH
Qq
"}
(8,1,1) = {"
Qq
pH
pH
pH
pH
rP
pH
pH
Vq
rP
pH
pH
pH
jT
pH
ln
pH
jT
pH
Qq
"}
(9,1,1) = {"
jT
jT
jT
jT
jT
jT
jT
jT
YU
jT
jT
jT
jT
jT
jT
jT
jT
UN
bI
Qq
"}
(10,1,1) = {"
jT
jT
jT
jT
jT
jT
jT
jT
jT
jT
jT
jT
jT
jT
jT
jT
jT
jT
pH
Qq
"}
(11,1,1) = {"
jT
jT
jT
jT
jT
jT
jT
jT
jT
jT
jT
jT
jT
jT
jT
jT
jT
jT
pH
Qq
"}
(12,1,1) = {"
Qq
pH
jT
pH
pH
rP
pH
pH
Vq
rP
pH
pH
jT
pH
pH
pH
pH
pH
pH
Qq
"}
(13,1,1) = {"
Qq
pH
jT
pH
pH
pH
pH
pH
Vq
pH
pH
bp
da
Lw
Lw
Lw
Lw
Lw
bp
Qq
"}
(14,1,1) = {"
Qq
pH
jT
pH
pH
pH
pH
pH
Vq
pH
pH
rV
pT
pT
vm
em
pT
pT
rV
Qq
"}
(15,1,1) = {"
Qq
pH
jT
pH
pH
pH
pH
pH
Vq
pH
pH
rV
ly
pT
JV
SG
pT
pT
rV
Qq
"}
(16,1,1) = {"
Qq
pH
jT
pH
pH
pH
pH
pH
Vq
pH
pH
lI
pT
pT
gz
so
pT
pT
rV
Qq
"}
(17,1,1) = {"
Qq
rQ
uj
rQ
pH
pH
pH
pH
Vq
pH
pH
rV
Ns
pT
pT
Sx
rV
pT
rV
Qq
"}
(18,1,1) = {"
Qq
rQ
qE
rQ
pH
pH
pH
pH
Vq
pH
pH
rV
UA
pT
pT
Sx
rV
Nk
rV
Qq
"}
(19,1,1) = {"
Qq
rQ
rQ
rQ
pH
pH
pH
pH
Vq
pH
pH
bp
Lw
Lw
Lw
Lw
Lw
Lw
bp
Qq
"}
(20,1,1) = {"
Qq
Qq
Qq
Qq
Qq
Qq
Qq
Qq
Qq
Qq
Qq
Qq
Qq
Qq
Qq
Qq
Qq
Qq
Qq
Qq
"}

(1,1,2) = {"
vg
vg
vg
vg
vg
vg
vg
vg
vg
vg
vg
vg
vg
vg
vg
vg
vg
vg
vg
vg
"}
(2,1,2) = {"
vg
vg
vg
vg
vg
vg
vg
vg
vg
vg
vg
vg
vg
vg
vg
vg
vg
vg
vg
vg
"}
(3,1,2) = {"
vg
vg
vg
vg
vg
vg
vg
vg
vg
vg
vg
rQ
vg
vg
rQ
vg
vg
rQ
vg
vg
"}
(4,1,2) = {"
vg
vg
vg
vg
vg
vg
vg
vg
vg
vg
vg
rQ
vg
rQ
rQ
vg
vg
rQ
vg
vg
"}
(5,1,2) = {"
vg
vg
vg
vg
vg
vg
vg
vg
vg
vg
vg
vg
vg
vg
vg
vg
vg
vg
vg
vg
"}
(6,1,2) = {"
vg
Dh
vg
vg
vg
vg
vg
vg
vg
vg
vg
vg
vg
vg
vg
vg
vg
vg
vg
vg
"}
(7,1,2) = {"
vg
TJ
vg
vg
vg
vg
vg
vg
vg
vg
vg
vg
vg
vg
vg
vg
vg
vg
vg
vg
"}
(8,1,2) = {"
vg
TJ
vg
vg
vg
vg
vg
vg
vg
vg
vg
vg
vg
vg
vg
vg
vg
vg
vg
vg
"}
(9,1,2) = {"
TJ
TJ
vg
vg
vg
vg
vg
vg
vg
vg
vg
vg
vg
vg
vg
vg
vg
vg
vg
vg
"}
(10,1,2) = {"
TJ
TJ
vg
vg
vg
vg
vg
vg
vg
vg
vg
vg
vg
vg
vg
vg
vg
vg
vg
vg
"}
(11,1,2) = {"
TJ
TJ
vg
vg
vg
vg
vg
vg
vg
vg
vg
vg
vg
vg
vg
vg
vg
vg
vg
vg
"}
(12,1,2) = {"
vg
TJ
vg
vg
vg
vg
vg
vg
vg
vg
vg
vg
vg
vg
vg
vg
vg
vg
vg
vg
"}
(13,1,2) = {"
vg
TJ
vg
vg
vg
vg
vg
vg
vg
vg
vg
bp
Lw
yJ
Lw
Lw
yJ
Lw
bp
vg
"}
(14,1,2) = {"
vg
TJ
vg
vg
vg
vg
vg
vg
vg
vg
vg
rV
KK
pT
tn
pT
pT
pT
rV
vg
"}
(15,1,2) = {"
vg
vg
vg
vg
vg
vg
vg
vg
vg
vg
vg
rV
JC
pT
pT
pT
pT
pT
rV
vg
"}
(16,1,2) = {"
vg
vg
vg
vg
vg
vg
vg
vg
vg
vg
vg
rV
sw
pT
di
Na
Na
Lh
rV
vg
"}
(17,1,2) = {"
vg
vg
rQ
vg
vg
vg
vg
vg
vg
vg
vg
rV
Jl
pT
gd
vg
VC
pT
rV
vg
"}
(18,1,2) = {"
vg
vg
rQ
vg
vg
vg
vg
vg
vg
vg
vg
rV
pQ
yp
gd
vg
VC
pT
rV
vg
"}
(19,1,2) = {"
vg
vg
vg
vg
vg
vg
vg
vg
vg
vg
vg
bp
Lw
Lw
Lw
Lw
Lw
Lw
bp
vg
"}
(20,1,2) = {"
vg
vg
vg
vg
vg
vg
vg
vg
vg
vg
vg
vg
vg
vg
vg
vg
vg
vg
vg
vg
"}
