//MAP CONVERTED BY dmm2tgm.py THIS HEADER COMMENT PREVENTS RECONVERSION, DO NOT REMOVE
"a" = (
/turf/open/transparent/openspace,
/area/rogue)
"b" = (
/obj/item/clothing/suit/roguetown/shirt/dress/gen/black,
/obj/item/clothing/cloak/apron/waist{
	pixel_x = 14;
	pixel_y = -8
	},
/turf/open/floor/rogue/naturalstone,
/area/rogue)
"e" = (
/obj/structure/spider/stickyweb,
/mob/living/simple_animal/hostile/retaliate/rogue/spider,
/turf/open/floor/rogue/naturalstone,
/area/rogue)
"g" = (
/obj/item/roguecoin/copper/pile,
/turf/open/floor/rogue/naturalstone,
/area/rogue)
"h" = (
/obj/effect/decal/cleanable/dirt/cobweb/cobweb2,
/turf/open/floor/rogue/naturalstone,
/area/rogue)
"i" = (
/turf/closed/mineral/rogue/bedrock,
/area/rogue)
"j" = (
/mob/living/simple_animal/hostile/retaliate/rogue/spider,
/obj/effect/decal/remains/human,
/turf/open/floor/rogue/naturalstone,
/area/rogue)
"m" = (
/obj/item/clothing/under/roguetown/tights,
/turf/open/floor/rogue/naturalstone,
/area/rogue)
"n" = (
/obj/structure/spider/stickyweb/solo,
/turf/open/floor/rogue/naturalstone,
/area/rogue)
"p" = (
/obj/item/clothing/suit/roguetown/armor/cuirass/iron,
/turf/open/floor/rogue/naturalstone,
/area/rogue)
"q" = (
/obj/structure/spider/stickyweb,
/obj/structure/spider/stickyweb,
/turf/open/floor/rogue/naturalstone,
/area/rogue)
"t" = (
/obj/item/clothing/under/roguetown/chainlegs/iron,
/turf/open/floor/rogue/naturalstone,
/area/rogue)
"u" = (
/obj/effect/decal/cleanable/dirt/cobweb,
/turf/open/floor/rogue/naturalstone,
/area/rogue)
"v" = (
/obj/item/storage/belt/rogue/leather/cloth,
/turf/open/floor/rogue/naturalstone,
/area/rogue)
"y" = (
/mob/living/simple_animal/hostile/retaliate/rogue/spider,
/obj/structure/spider/stickyweb,
/turf/open/floor/rogue/naturalstone,
/area/rogue)
"z" = (
/obj/item/reagent_containers/food/snacks/rogue/bun_grenz{
	pixel_x = 14;
	pixel_y = 4
	},
/turf/open/floor/rogue/naturalstone,
/area/rogue)
"A" = (
/obj/effect/decal/remains/human,
/obj/effect/decal/cleanable/dirt/cobweb,
/obj/item/restraints/legcuffs/beartrap/armed/camouflage,
/obj/item/clothing/cloak/raincloak/furcloak/black{
	pixel_x = 14
	},
/turf/open/floor/rogue/naturalstone,
/area/rogue)
"B" = (
/obj/effect/decal/remains/human,
/turf/closed/mineral/rogue,
/area/rogue)
"D" = (
/obj/effect/decal/remains/human,
/obj/effect/decal/cleanable/dirt/cobweb,
/turf/open/floor/rogue/naturalstone,
/area/rogue)
"G" = (
/obj/effect/decal/cleanable/dirt/cobweb/cobweb2,
/obj/item/clothing/head/roguetown/helmet/skullcap/grenzelhoft{
	pixel_y = -15
	},
/turf/open/floor/rogue/naturalstone,
/area/rogue)
"H" = (
/mob/living/simple_animal/hostile/retaliate/rogue/spider,
/turf/open/floor/rogue/naturalstone,
/area/rogue)
"I" = (
/obj/effect/landmark/ambush,
/turf/open/floor/rogue/naturalstone,
/area/rogue)
"J" = (
/obj/structure/spider/stickyweb,
/turf/closed/mineral/rogue,
/area/rogue)
"K" = (
/obj/effect/decal/remains/human,
/obj/effect/decal/cleanable/dirt/cobweb,
/obj/structure/spider/stickyweb/solo,
/turf/open/floor/rogue/naturalstone,
/area/rogue)
"L" = (
/obj/item/ingot/iron,
/obj/item/ingot/iron,
/obj/item/ingot/iron{
	pixel_x = 11;
	pixel_y = -5
	},
/obj/item/ingot/iron{
	pixel_y = 4;
	pixel_x = 7
	},
/turf/open/floor/rogue/naturalstone,
/area/rogue)
"M" = (
/turf/closed/mineral/rogue,
/area/rogue)
"N" = (
/obj/item/clothing/suit/roguetown/shirt,
/obj/item/clothing/suit/roguetown/shirt,
/obj/item/clothing/suit/roguetown/shirt,
/obj/item/clothing/suit/roguetown/shirt/rags,
/turf/open/floor/rogue/naturalstone,
/area/rogue)
"O" = (
/obj/effect/decal/remains/human,
/obj/structure/spider/stickyweb/solo,
/turf/open/floor/rogue/naturalstone,
/area/rogue)
"R" = (
/obj/item/restraints/legcuffs/beartrap/armed/camouflage,
/turf/open/floor/rogue/naturalstone,
/area/rogue)
"U" = (
/obj/item/clothing/suit/roguetown/shirt/grenzelhoft{
	pixel_x = -4;
	pixel_y = 19
	},
/obj/item/clothing/under/roguetown/grenzelpants{
	pixel_x = 10
	},
/obj/item/clothing/shoes/roguetown/grenzelhoft{
	pixel_x = -12;
	pixel_y = -13
	},
/turf/open/floor/rogue/naturalstone,
/area/rogue)
"V" = (
/obj/item/roguestatue/iron,
/turf/open/floor/rogue/naturalstone,
/area/rogue)
"W" = (
/obj/effect/decal/remains/human,
/turf/open/floor/rogue/naturalstone,
/area/rogue)
"X" = (
/turf/open/floor/rogue/naturalstone,
/area/rogue)
"Y" = (
/obj/structure/spider/stickyweb,
/turf/open/floor/rogue/naturalstone,
/area/rogue)
"Z" = (
/mob/living/simple_animal/hostile/retaliate/rogue/spider,
/obj/effect/decal/cleanable/dirt/cobweb,
/obj/item/storage/belt/rogue/pouch/coins/mid,
/turf/open/floor/rogue/naturalstone,
/area/rogue)

(1,1,1) = {"
i
i
i
i
i
i
i
i
X
X
X
i
i
i
i
i
i
i
i
i
"}
(2,1,1) = {"
i
X
X
X
X
X
X
X
X
X
X
X
X
X
X
X
X
X
X
i
"}
(3,1,1) = {"
i
X
X
X
X
X
X
X
M
X
M
M
M
X
X
X
X
M
X
i
"}
(4,1,1) = {"
i
X
M
M
B
M
X
M
B
X
X
X
X
X
M
M
X
M
X
i
"}
(5,1,1) = {"
i
X
X
M
A
X
X
M
D
X
M
X
M
M
M
M
M
X
X
i
"}
(6,1,1) = {"
i
M
X
M
b
M
X
M
M
X
M
X
M
K
M
M
X
X
X
i
"}
(7,1,1) = {"
i
X
X
M
v
M
X
X
X
X
X
I
M
O
M
M
M
X
X
i
"}
(8,1,1) = {"
i
X
X
X
X
X
X
M
M
Y
M
X
X
X
X
X
R
X
X
i
"}
(9,1,1) = {"
X
X
X
M
M
X
X
M
u
Y
M
M
Y
M
X
X
M
X
X
X
"}
(10,1,1) = {"
X
X
X
M
u
X
X
M
M
Y
e
J
Y
M
h
M
M
M
X
X
"}
(11,1,1) = {"
X
X
X
M
X
M
X
X
M
G
z
U
e
J
M
M
Y
X
X
X
"}
(12,1,1) = {"
i
X
X
X
X
R
M
X
M
M
Y
Y
Y
X
X
X
Y
J
X
i
"}
(13,1,1) = {"
i
X
X
M
W
X
X
X
Y
q
q
H
n
W
Y
M
M
X
X
i
"}
(14,1,1) = {"
i
X
X
M
M
N
m
X
M
M
Y
J
Y
H
Y
Y
M
M
X
i
"}
(15,1,1) = {"
i
X
X
X
R
X
X
X
M
Z
Y
e
Y
j
Y
Y
Y
Y
X
i
"}
(16,1,1) = {"
i
X
M
X
M
X
I
X
M
L
M
t
Y
M
Y
H
M
X
X
i
"}
(17,1,1) = {"
i
X
M
X
X
X
X
X
M
e
V
p
Y
Y
Y
X
M
M
X
i
"}
(18,1,1) = {"
i
X
X
M
X
X
X
X
M
J
J
J
J
J
J
J
X
X
X
i
"}
(19,1,1) = {"
i
M
X
X
X
M
M
X
X
X
X
X
X
X
X
X
X
M
X
i
"}
(20,1,1) = {"
i
i
i
i
i
i
i
i
i
X
X
X
i
i
i
i
i
i
i
i
"}

(1,1,2) = {"
i
i
i
i
i
i
i
i
X
X
X
X
i
i
i
i
i
i
i
i
"}
(2,1,2) = {"
i
a
a
a
a
a
a
a
a
a
a
a
a
a
a
a
a
a
a
i
"}
(3,1,2) = {"
i
a
a
a
a
a
a
a
X
a
X
X
X
a
a
a
a
X
a
i
"}
(4,1,2) = {"
i
a
X
X
X
X
a
W
Y
a
a
a
a
a
X
X
a
X
a
i
"}
(5,1,2) = {"
i
a
a
X
a
a
a
X
a
a
a
a
X
X
Y
X
X
a
a
i
"}
(6,1,2) = {"
i
X
a
X
a
Y
a
X
X
a
a
a
X
a
X
Y
a
a
a
i
"}
(7,1,2) = {"
i
a
a
X
a
X
a
a
a
a
a
a
X
a
X
X
X
a
a
i
"}
(8,1,2) = {"
i
a
a
a
a
a
a
X
X
a
X
a
a
a
a
a
a
a
a
i
"}
(9,1,2) = {"
X
a
a
X
X
a
a
Y
a
a
X
X
X
X
a
a
X
a
a
X
"}
(10,1,2) = {"
X
X
a
Y
a
a
a
X
X
a
a
a
Y
X
X
X
X
X
a
X
"}
(11,1,2) = {"
X
X
a
X
a
X
a
a
Y
a
a
a
Y
a
Y
Y
Y
X
a
X
"}
(12,1,2) = {"
X
a
a
a
a
a
X
a
X
y
a
a
y
a
a
a
X
a
a
X
"}
(13,1,2) = {"
X
X
a
X
a
a
a
a
X
Y
X
X
g
a
X
X
X
a
a
X
"}
(14,1,2) = {"
i
a
a
Y
X
a
a
a
X
Y
Y
y
X
a
X
a
X
X
a
i
"}
(15,1,2) = {"
i
X
a
a
a
a
a
a
X
a
X
X
W
a
X
a
a
a
a
i
"}
(16,1,2) = {"
i
a
X
a
X
a
a
a
X
a
X
a
X
a
X
a
X
a
a
i
"}
(17,1,2) = {"
i
a
X
a
a
a
a
a
X
y
Y
a
y
X
X
a
X
X
a
i
"}
(18,1,2) = {"
i
a
a
X
a
a
a
a
X
X
X
X
X
X
X
a
a
a
a
i
"}
(19,1,2) = {"
i
X
a
a
a
X
X
a
a
a
a
a
a
a
a
a
a
X
a
i
"}
(20,1,2) = {"
i
i
i
i
i
i
i
i
X
X
X
X
i
i
i
i
i
i
i
i
"}
