//MAP CONVERTED BY dmm2tgm.py THIS HEADER COMMENT PREVENTS RECONVERSION, DO NOT REMOVE
"a" = (
/turf/closed/mineral/rogue/bedrock,
/area/rogue)
"b" = (
/obj/item/natural/stone,
/turf/open/floor/rogue/naturalstone,
/area/rogue)
"c" = (
/obj/item/natural/stone{
	pixel_y = -4;
	pixel_x = 6
	},
/turf/open/floor/rogue/naturalstone,
/area/rogue)
"e" = (
/turf/open/floor/rogue/naturalstone,
/area/rogue)
"B" = (
/obj/item/natural/stone{
	pixel_x = -17;
	pixel_y = 18
	},
/turf/open/floor/rogue/naturalstone,
/area/rogue)
"C" = (
/obj/item/natural/stone{
	pixel_x = -1;
	pixel_y = 4
	},
/turf/open/floor/rogue/naturalstone,
/area/rogue)
"S" = (
/obj/item/natural/stone{
	pixel_x = 10;
	pixel_y = -6
	},
/turf/open/floor/rogue/naturalstone,
/area/rogue)
"T" = (
/obj/item/natural/stone{
	pixel_x = -6;
	pixel_y = -16
	},
/turf/open/floor/rogue/naturalstone,
/area/rogue)
"Y" = (
/obj/item/natural/stone{
	pixel_x = -17;
	pixel_y = -6
	},
/turf/open/floor/rogue/naturalstone,
/area/rogue)

(1,1,1) = {"
a
a
a
a
a
a
a
a
a
a
a
a
a
a
a
a
a
a
a
a
"}
(2,1,1) = {"
a
e
e
e
a
a
a
e
e
e
e
e
a
a
a
a
e
e
e
a
"}
(3,1,1) = {"
a
e
a
e
e
e
e
e
e
e
e
e
e
a
a
e
a
a
e
a
"}
(4,1,1) = {"
a
e
e
a
a
e
e
e
e
e
e
Y
e
e
a
e
e
e
e
a
"}
(5,1,1) = {"
a
e
e
a
e
e
e
a
a
a
a
a
e
e
e
e
a
e
e
a
"}
(6,1,1) = {"
a
a
a
a
e
e
e
a
e
e
e
e
e
e
a
a
a
a
a
a
"}
(7,1,1) = {"
a
a
a
e
Y
e
a
a
e
a
e
e
e
a
a
a
a
a
e
e
"}
(8,1,1) = {"
e
e
a
e
B
B
a
a
a
e
S
e
e
a
a
a
a
e
e
e
"}
(9,1,1) = {"
e
e
a
e
a
a
a
a
e
e
e
a
a
a
a
a
e
e
e
e
"}
(10,1,1) = {"
e
e
a
e
e
a
a
a
e
Y
e
a
a
a
a
a
e
C
e
e
"}
(11,1,1) = {"
e
e
a
e
e
a
a
e
e
a
a
a
a
e
e
e
e
C
e
e
"}
(12,1,1) = {"
e
e
e
e
e
a
a
e
e
a
a
a
e
e
e
e
e
e
e
e
"}
(13,1,1) = {"
e
e
e
e
a
a
a
e
e
a
a
e
e
e
e
e
e
e
e
e
"}
(14,1,1) = {"
a
a
a
a
a
a
e
e
a
a
a
e
e
a
a
a
a
a
a
a
"}
(15,1,1) = {"
a
e
e
e
a
a
e
e
a
a
a
c
S
a
e
e
e
e
a
a
"}
(16,1,1) = {"
a
e
a
e
e
e
e
e
e
S
e
T
b
a
e
a
e
e
e
a
"}
(17,1,1) = {"
a
e
a
a
a
a
a
e
e
e
e
e
e
a
e
a
e
e
e
a
"}
(18,1,1) = {"
a
e
e
a
e
e
e
a
a
a
a
a
a
a
e
a
e
e
e
a
"}
(19,1,1) = {"
a
e
e
e
e
e
e
e
e
e
e
e
e
e
e
a
e
e
a
a
"}
(20,1,1) = {"
a
a
a
a
a
a
a
a
a
a
a
a
a
a
a
a
a
a
a
a
"}

(1,1,2) = {"
a
a
a
a
a
a
a
a
a
a
a
a
a
a
a
a
a
a
a
a
"}
(2,1,2) = {"
a
e
e
e
a
a
a
e
e
e
e
e
a
a
a
a
e
e
e
a
"}
(3,1,2) = {"
a
e
a
e
e
e
e
e
e
e
e
e
e
a
a
e
a
a
e
a
"}
(4,1,2) = {"
a
e
e
a
a
e
e
e
e
e
e
Y
e
e
a
e
e
e
e
a
"}
(5,1,2) = {"
a
e
e
a
e
e
e
a
a
a
a
a
e
e
e
e
a
e
e
a
"}
(6,1,2) = {"
a
a
a
a
e
e
e
a
e
e
e
e
e
e
a
a
a
a
a
a
"}
(7,1,2) = {"
a
a
a
e
Y
e
a
a
e
a
e
e
e
a
a
a
a
a
e
e
"}
(8,1,2) = {"
e
e
a
e
B
B
a
a
a
e
S
e
e
a
a
a
a
e
e
e
"}
(9,1,2) = {"
e
e
a
e
a
a
a
a
e
e
e
a
a
a
a
a
e
e
e
e
"}
(10,1,2) = {"
e
e
a
e
e
a
a
a
e
Y
e
a
a
a
a
a
e
C
e
e
"}
(11,1,2) = {"
e
e
a
e
e
a
a
e
e
a
a
a
a
e
e
e
e
C
e
e
"}
(12,1,2) = {"
e
e
e
e
e
a
a
e
e
a
a
a
e
e
e
e
e
e
e
e
"}
(13,1,2) = {"
e
e
e
e
a
a
a
e
e
a
a
e
e
e
e
e
e
e
e
e
"}
(14,1,2) = {"
a
a
a
a
a
a
e
e
a
a
a
e
e
a
a
a
a
a
a
a
"}
(15,1,2) = {"
a
e
e
e
a
a
e
e
a
a
a
c
S
a
e
e
e
e
a
a
"}
(16,1,2) = {"
a
e
a
e
e
e
e
e
e
S
e
T
b
a
e
a
e
e
e
a
"}
(17,1,2) = {"
a
e
a
a
a
a
a
e
e
e
e
e
e
a
e
a
e
e
e
a
"}
(18,1,2) = {"
a
e
e
a
e
e
e
a
a
a
a
a
a
a
e
a
e
e
e
a
"}
(19,1,2) = {"
a
e
e
e
e
e
e
e
e
e
e
e
e
e
e
a
e
e
a
a
"}
(20,1,2) = {"
a
a
a
a
a
a
a
a
a
a
a
a
a
a
a
a
a
a
a
a
"}
