//MAP CONVERTED BY dmm2tgm.py THIS HEADER COMMENT PREVENTS RECONVERSION, DO NOT REMOVE
"a" = (
/turf/closed/wall/mineral/rogue/craftstone,
/area/rogue)
"e" = (
/turf/open/floor/rogue/hexstone,
/area/rogue)

(1,1,1) = {"
a
a
a
a
a
a
"}
(2,1,1) = {"
e
e
e
e
e
e
"}
(3,1,1) = {"
a
a
a
a
a
a
"}

(1,1,2) = {"
a
a
a
a
a
a
"}
(2,1,2) = {"
e
e
e
e
e
e
"}
(3,1,2) = {"
a
a
a
a
a
a
"}
