//MAP CONVERTED BY dmm2tgm.py THIS HEADER COMMENT PREVENTS RECONVERSION, DO NOT REMOVE
"aF" = (
/obj/structure/closet/crate/chest/neu_fancy{
	locked = 1
	},
/obj/item/rogueweapon/knife/dagger/silver,
/obj/item/reagent_containers/powder/moondust_purest,
/obj/item/reagent_containers/powder/moondust_purest{
	pixel_y = -4;
	pixel_x = -3
	},
/obj/item/reagent_containers/powder/moondust_purest{
	pixel_x = 6
	},
/obj/item/reagent_containers/powder/ozium{
	pixel_y = -8;
	pixel_x = -1
	},
/turf/open/floor/rogue/ruinedwood/turned/darker,
/area/rogue)
"bf" = (
/obj/structure/fluff/walldeco/vinez/r,
/turf/open/floor/rogue/blocks,
/area/rogue)
"ch" = (
/obj/structure/stairs/d{
	dir = 4
	},
/turf/closed,
/area/rogue)
"ck" = (
/obj/structure/table/wood/counter,
/obj/structure/bars/alt,
/obj/item/candle/yellow/lit,
/turf/open/floor/rogue/cobblerock,
/area/rogue)
"cn" = (
/obj/item/alch/golddust,
/obj/structure/closet/crate/chest/neu_fancy{
	locked = 1
	},
/obj/item/reagent_containers/powder/blastpowder,
/obj/item/reagent_containers/powder/blastpowder,
/obj/item/reagent_containers/powder/blastpowder,
/turf/open/floor/rogue/ruinedwood/turned/darker,
/area/rogue)
"cz" = (
/obj/structure/mineral_door/swing_door,
/turf/open/floor/rogue/cobblerock,
/area/rogue)
"cD" = (
/obj/structure/kneestingers{
	pixel_y = 12
	},
/turf/open/floor/rogue/cobblerock,
/area/rogue)
"dt" = (
/obj/structure/table/wood/counter{
	dir = 1
	},
/obj/item/reagent_containers/food/snacks/rotten/breadslice,
/turf/open/floor/rogue/dirt,
/area/rogue)
"gY" = (
/obj/structure/closet/crate/drawer/inn,
/turf/open/floor/rogue/ruinedwood/turned/darker,
/area/rogue)
"ix" = (
/obj/structure/closet/crate/chest/wicker,
/obj/item/reagent_containers/food/snacks/produce/wheat,
/obj/item/reagent_containers/food/snacks/produce/wheat,
/obj/item/reagent_containers/food/snacks/produce/wheat,
/obj/item/reagent_containers/food/snacks/produce/wheat,
/obj/item/reagent_containers/food/snacks/produce/wheat,
/obj/item/reagent_containers/food/snacks/rogue/raisins,
/obj/item/reagent_containers/food/snacks/rogue/raisins,
/obj/item/reagent_containers/food/snacks/rogue/raisins,
/obj/item/reagent_containers/food/snacks/rogue/raisins,
/obj/item/reagent_containers/food/snacks/rogue/raisins,
/turf/open/floor/rogue/ruinedwood/turned/darker,
/area/rogue)
"iX" = (
/turf/closed/mineral/rogue/bedrock,
/area/rogue)
"jS" = (
/obj/structure/ladder,
/turf/open/floor/rogue/ruinedwood/turned/darker,
/area/rogue)
"kz" = (
/obj/structure/stairs{
	dir = 4
	},
/turf/open/floor/rogue/ruinedwood/turned/darker,
/area/rogue)
"kH" = (
/obj/structure/table/wood/counter{
	dir = 1
	},
/obj/item/reagent_containers/food/snacks/rotten/breadslice,
/turf/open/floor/rogue/ruinedwood/turned/darker,
/area/rogue)
"mG" = (
/obj/machinery/light/rogue/campfire/longlived,
/turf/open/floor/rogue/ruinedwood/turned/darker,
/area/rogue)
"mH" = (
/turf/open/floor/rogue/cobblerock,
/area/rogue)
"np" = (
/obj/structure/table/wood/plain_alt,
/obj/structure/fluff/millstone,
/obj/item/rogueweapon/knife/cleaver{
	pixel_y = 7;
	pixel_x = -2
	},
/turf/open/floor/rogue/ruinedwood/turned/darker,
/area/rogue)
"nw" = (
/turf/open/floor/rogue/ruinedwood/turned/darker,
/area/rogue)
"nZ" = (
/obj/structure/fluff/walldeco/vinez,
/turf/closed/wall/mineral/rogue/stone/moss,
/area/rogue)
"oo" = (
/turf/open/transparent/openspace,
/area/rogue)
"oP" = (
/obj/structure/fluff/walldeco/vinez/offset,
/turf/open/floor/rogue/cobblerock,
/area/rogue)
"pQ" = (
/mob/living/carbon/human/species/skeleton/npc/peasant,
/turf/open/floor/rogue/dirt,
/area/rogue)
"qO" = (
/obj/structure/closet/crate/chest/wicker,
/obj/item/alch/bonemeal,
/obj/item/alch/bonemeal,
/obj/item/alch/bonemeal,
/turf/open/floor/rogue/ruinedwood/turned/darker,
/area/rogue)
"ri" = (
/obj/structure/closet/crate/drawer/inn,
/obj/item/clothing/mask/cigarette/pipe/westman,
/obj/item/clothing/mask/cigarette/rollie/trippy,
/obj/item/clothing/mask/cigarette/rollie/trippy,
/obj/item/clothing/mask/cigarette/rollie/trippy{
	pixel_y = 8
	},
/obj/item/clothing/mask/cigarette/rollie/trippy{
	pixel_y = 14;
	pixel_x = -7
	},
/obj/item/clothing/mask/rogue/spectacles/golden,
/turf/open/floor/rogue/ruinedwood/turned/darker,
/area/rogue)
"rT" = (
/obj/structure/wallladder{
	dir = 4
	},
/turf/open/floor/rogue/dirt,
/area/rogue)
"rY" = (
/obj/item/candle/yellow/lit{
	pixel_y = 10;
	pixel_x = -10
	},
/obj/item/organ/eyes/night_vision/werewolf,
/obj/item/organ/eyes/night_vision/werewolf{
	pixel_y = -6;
	pixel_x = -12
	},
/obj/structure/table/wood/plain_alt,
/obj/item/storage/backpack/rogue/satchel/surgbag{
	pixel_x = 7
	},
/turf/open/floor/rogue/ruinedwood/turned/darker,
/area/rogue)
"tj" = (
/obj/structure/closet/crate/chest/wicker,
/obj/item/reagent_containers/food/snacks/produce/wheat,
/obj/item/reagent_containers/food/snacks/produce/wheat,
/obj/item/reagent_containers/food/snacks/produce/wheat,
/obj/item/reagent_containers/food/snacks/produce/wheat,
/turf/open/floor/rogue/ruinedwood/turned/darker,
/area/rogue)
"tm" = (
/obj/structure/kneestingers{
	pixel_y = 12
	},
/turf/open/floor/rogue/plank/h,
/area/rogue)
"to" = (
/obj/structure/table/wood/counter/end{
	dir = 8
	},
/obj/structure/bars/alt,
/turf/open/floor/rogue/cobblerock,
/area/rogue)
"un" = (
/obj/structure/closet/crate/chest{
	locked = 1
	},
/obj/item/reagent_containers/glass/bottle/rogue/healthpot,
/obj/item/reagent_containers/glass/bottle/rogue/healthpot,
/obj/item/reagent_containers/glass/bottle/rogue/healthpot{
	pixel_x = -8
	},
/turf/open/floor/rogue/ruinedwood/turned/darker,
/area/rogue)
"uC" = (
/obj/structure/bed/rogue/shit,
/turf/open/floor/rogue/ruinedwood/turned/darker,
/area/rogue)
"wk" = (
/mob/living/carbon/human/species/skeleton/npc/ambush,
/turf/open/floor/rogue/ruinedwood/turned/darker,
/area/rogue)
"wp" = (
/obj/structure/kneestingers{
	pixel_y = 12
	},
/turf/open/floor/rogue/dirt,
/area/rogue)
"xq" = (
/obj/structure/closet/crate/roguecloset/inn/south,
/obj/item/clothing/cloak/wickercloak,
/obj/item/clothing/gloves/roguetown/fingerless,
/obj/item/clothing/head/roguetown/antlerhood,
/obj/item/clothing/mask/rogue/skullmask,
/turf/open/floor/rogue/ruinedwood/turned/darker,
/area/rogue)
"yt" = (
/obj/structure/wallladder{
	dir = 4
	},
/turf/open/floor/rogue/ruinedwood/turned/darker,
/area/rogue)
"yv" = (
/obj/structure/bars,
/turf/open/floor/rogue/ruinedwood/turned/darker,
/area/rogue)
"yE" = (
/obj/structure/table/wood/counter,
/obj/structure/bars/alt,
/turf/open/floor/rogue/cobblerock,
/area/rogue)
"zG" = (
/obj/effect/landmark/chest_or_mimic,
/obj/item/reagent_containers/glass/bottle/rogue/stronghealthpot,
/turf/open/floor/rogue/ruinedwood/turned/darker,
/area/rogue)
"Am" = (
/turf/open/floor/rogue/blocks,
/area/rogue)
"Bv" = (
/obj/structure/kneestingers{
	pixel_y = 12
	},
/turf/open/floor/rogue/ruinedwood/turned/darker,
/area/rogue)
"BM" = (
/obj/structure/closet/crate/chest/wicker,
/obj/item/alch/golddust,
/obj/item/alch/silverdust,
/obj/item/alch/irondust,
/turf/open/floor/rogue/ruinedwood/turned/darker,
/area/rogue)
"BP" = (
/obj/structure/fluff/walldeco/vinez/r,
/turf/open/floor/rogue/ruinedwood/turned/darker,
/area/rogue)
"CD" = (
/obj/structure/kneestingers,
/turf/open/floor/rogue/ruinedwood/turned/darker,
/area/rogue)
"CE" = (
/obj/structure/table/optable,
/obj/structure/fluff/walldeco/chains{
	pixel_y = 21;
	pixel_x = 9
	},
/turf/open/floor/rogue/ruinedwood/turned/darker,
/area/rogue)
"Dj" = (
/mob/living/carbon/human/species/zizombie/ambush,
/turf/open/floor/rogue/ruinedwood/turned/darker,
/area/rogue)
"EJ" = (
/obj/structure/bed/rogue/inn/double,
/obj/item/bedsheet/rogue/fabric_double,
/turf/open/floor/rogue/ruinedwood/turned/darker,
/area/rogue)
"EK" = (
/obj/structure/closet/crate/chest/wicker,
/obj/item/reagent_containers/food/snacks/produce/wheat,
/obj/item/reagent_containers/food/snacks/produce/wheat,
/obj/item/reagent_containers/food/snacks/produce/wheat,
/obj/item/reagent_containers/food/snacks/produce/wheat,
/obj/item/reagent_containers/food/snacks/produce/wheat,
/obj/item/reagent_containers/food/snacks/rogue/raisins,
/obj/item/reagent_containers/food/snacks/rogue/raisins,
/obj/item/reagent_containers/food/snacks/rogue/raisins,
/obj/item/reagent_containers/food/snacks/rogue/raisins,
/obj/item/reagent_containers/food/snacks/rogue/raisins,
/obj/item/reagent_containers/food/snacks/rogue/raisins,
/turf/open/floor/rogue/ruinedwood/turned/darker,
/area/rogue)
"EU" = (
/obj/structure/kneestingers{
	pixel_y = 11
	},
/turf/open/floor/rogue/plank/h,
/area/rogue)
"FJ" = (
/obj/structure/table/wood/counter/end,
/obj/item/reagent_containers/food/snacks/rotten/breadslice,
/obj/item/reagent_containers/food/snacks/rotten/breadslice{
	pixel_y = 3;
	pixel_x = 2
	},
/obj/item/reagent_containers/food/snacks/rotten/breadslice{
	pixel_y = 7;
	pixel_x = 3
	},
/turf/open/floor/rogue/dirt,
/area/rogue)
"Ga" = (
/obj/structure/closet/crate/chest,
/obj/item/reagent_containers/food/snacks/rogue/meat/coppiette,
/turf/open/floor/rogue/ruinedwood/turned/darker,
/area/rogue)
"Hv" = (
/turf/open/floor/rogue/plank/h,
/area/rogue)
"Jl" = (
/obj/structure/closet/crate/chest/wicker,
/obj/item/reagent_containers/food/snacks/produce/wheat,
/obj/item/reagent_containers/food/snacks/produce/wheat,
/obj/item/reagent_containers/food/snacks/produce/wheat,
/obj/item/reagent_containers/food/snacks/produce/wheat,
/obj/item/reagent_containers/food/snacks/produce/wheat,
/obj/item/reagent_containers/food/snacks/produce/wheat,
/turf/open/floor/rogue/ruinedwood/turned/darker,
/area/rogue)
"Ld" = (
/obj/item/reagent_containers/glass/bucket/wooden,
/turf/open/floor/rogue/cobblerock,
/area/rogue)
"MK" = (
/obj/structure/mineral_door/bars{
	locked = 1
	},
/turf/open/floor/rogue/ruinedwood/turned/darker,
/area/rogue)
"Qb" = (
/obj/structure/closet/crate/chest/wicker,
/obj/item/reagent_containers/food/snacks/produce/wheat,
/obj/item/reagent_containers/food/snacks/produce/wheat,
/obj/item/reagent_containers/food/snacks/produce/wheat,
/obj/item/reagent_containers/food/snacks/produce/wheat,
/obj/item/reagent_containers/food/snacks/produce/wheat,
/obj/item/reagent_containers/food/snacks/produce/wheat,
/obj/item/reagent_containers/food/snacks/produce/wheat,
/turf/open/floor/rogue/ruinedwood/turned/darker,
/area/rogue)
"QB" = (
/turf/closed/wall/mineral/rogue/stone,
/area/rogue)
"SO" = (
/obj/structure/closet/crate/chest/wicker,
/obj/item/alch/horn,
/turf/open/floor/rogue/ruinedwood/turned/darker,
/area/rogue)
"Tj" = (
/turf/closed/wall/mineral/rogue/stone/moss,
/area/rogue)
"Ty" = (
/turf/open/floor/rogue/dirt,
/area/rogue)
"Ub" = (
/obj/structure/well,
/turf/open/floor/rogue/cobblerock,
/area/rogue)
"UC" = (
/obj/structure/fluff/walldeco/vinez,
/turf/open/floor/rogue/dirt,
/area/rogue)
"Vl" = (
/obj/structure/fluff/walldeco/vinez/r,
/turf/open/floor/rogue/cobblerock,
/area/rogue)
"Wq" = (
/obj/effect/decal/remains/human,
/obj/structure/fluff/walldeco/vinez/l,
/turf/open/floor/rogue/ruinedwood/turned/darker,
/area/rogue)
"Xu" = (
/obj/structure/closet/crate/chest/wicker,
/obj/item/alch/magicdust,
/obj/item/alch/magicdust,
/turf/open/floor/rogue/ruinedwood/turned/darker,
/area/rogue)
"Zr" = (
/obj/structure/bed/rogue/hay,
/turf/open/floor/rogue/ruinedwood/turned/darker,
/area/rogue)
"ZJ" = (
/obj/structure/mineral_door/wood/violet{
	locked = 1
	},
/turf/open/floor/rogue/cobblerock,
/area/rogue)
"ZL" = (
/obj/item/clothing/head/roguetown/hatblu,
/turf/open/floor/rogue/ruinedwood/turned/darker,
/area/rogue)
"ZT" = (
/obj/machinery/light/rogue/oven/west,
/obj/machinery/light/rogue/oven/south,
/turf/open/floor/rogue/ruinedwood/turned/darker,
/area/rogue)

(1,1,1) = {"
iX
iX
iX
iX
iX
iX
iX
iX
iX
mH
mH
iX
iX
iX
iX
iX
iX
iX
iX
iX
"}
(2,1,1) = {"
iX
mH
mH
mH
mH
mH
mH
mH
mH
mH
mH
Ty
Ty
Ty
Ty
Ty
Ty
Ty
Ty
iX
"}
(3,1,1) = {"
iX
mH
mH
mH
mH
mH
mH
mH
mH
mH
mH
Ty
Ty
Ty
Ty
Ty
Ty
Ty
Ty
iX
"}
(4,1,1) = {"
iX
mH
mH
Tj
Tj
rT
Ty
Tj
Tj
mH
mH
Tj
Tj
QB
QB
Tj
Tj
Ty
Ty
iX
"}
(5,1,1) = {"
iX
mH
mH
Tj
nw
nw
nw
nw
Tj
oP
mH
QB
CE
Wq
nw
jS
Tj
Ty
Ty
iX
"}
(6,1,1) = {"
iX
mH
mH
QB
gY
Ty
Ty
nw
Ty
mH
mH
Tj
rY
nw
nw
un
QB
Ty
Ty
iX
"}
(7,1,1) = {"
iX
mH
mH
QB
Zr
ZL
nw
nw
QB
oP
mH
Tj
nw
nw
nw
zG
QB
Ty
Ty
iX
"}
(8,1,1) = {"
iX
mH
mH
Tj
nw
Dj
nw
nw
Tj
oP
mH
Tj
nw
nw
BP
BP
Tj
Ty
Ty
iX
"}
(9,1,1) = {"
iX
mH
mH
Tj
QB
Tj
QB
Tj
mH
Vl
mH
QB
ck
yE
to
ZJ
Tj
Ty
Ty
iX
"}
(10,1,1) = {"
mH
mH
mH
mH
mH
mH
mH
mH
mH
Ub
mH
cz
Am
Am
Am
Am
QB
Ty
Ty
mH
"}
(11,1,1) = {"
mH
mH
mH
mH
mH
mH
mH
mH
mH
Ld
mH
Tj
Ty
Am
bf
Am
Tj
Ty
Ty
mH
"}
(12,1,1) = {"
iX
mH
mH
Tj
QB
Tj
Tj
QB
Tj
mH
mH
Tj
Ty
Tj
QB
Tj
Tj
Ty
Ty
iX
"}
(13,1,1) = {"
iX
mH
mH
Tj
np
nw
nw
nw
Tj
mH
mH
mH
mH
mH
mH
mH
mH
mH
mH
iX
"}
(14,1,1) = {"
iX
mH
mH
Tj
nw
pQ
FJ
nw
UC
mH
mH
mH
mH
mH
cD
mH
mH
mH
mH
iX
"}
(15,1,1) = {"
iX
mH
mH
QB
kz
nw
dt
nw
nZ
mH
mH
mH
Tj
Tj
QB
QB
Tj
mH
mH
iX
"}
(16,1,1) = {"
iX
mH
mH
Tj
QB
ZT
kH
nw
UC
mH
mH
mH
cD
Ty
wp
Ga
Tj
mH
mH
iX
"}
(17,1,1) = {"
iX
mH
mH
Tj
Tj
QB
Tj
Tj
Tj
mH
mH
mH
Tj
Ty
yt
tj
QB
mH
mH
iX
"}
(18,1,1) = {"
iX
mH
mH
mH
mH
mH
mH
mH
mH
mH
mH
mH
Tj
Bv
nw
nw
QB
mH
mH
iX
"}
(19,1,1) = {"
iX
mH
mH
mH
mH
mH
mH
mH
mH
mH
mH
mH
Tj
Tj
Tj
Tj
Tj
mH
mH
iX
"}
(20,1,1) = {"
iX
iX
iX
iX
iX
iX
iX
iX
iX
mH
mH
mH
iX
iX
iX
iX
iX
iX
iX
iX
"}

(1,1,2) = {"
iX
iX
iX
iX
iX
iX
iX
iX
iX
oo
oo
iX
iX
iX
iX
iX
iX
iX
iX
iX
"}
(2,1,2) = {"
iX
oo
oo
oo
oo
oo
oo
oo
oo
oo
oo
oo
oo
oo
oo
oo
oo
oo
oo
iX
"}
(3,1,2) = {"
iX
oo
oo
oo
oo
oo
oo
oo
oo
oo
oo
oo
oo
oo
oo
oo
oo
oo
oo
iX
"}
(4,1,2) = {"
iX
oo
oo
Tj
Tj
oo
oo
Tj
Tj
oo
oo
QB
QB
QB
QB
QB
QB
oo
oo
iX
"}
(5,1,2) = {"
iX
oo
oo
Tj
nw
nw
nw
nw
Tj
oo
oo
QB
Xu
SO
yv
jS
QB
oo
oo
iX
"}
(6,1,2) = {"
iX
oo
oo
Tj
nw
mG
nw
nw
oo
oo
oo
QB
BM
wk
MK
nw
QB
oo
oo
iX
"}
(7,1,2) = {"
iX
oo
oo
Tj
nw
nw
nw
nw
Tj
oo
oo
QB
qO
cn
yv
nw
QB
oo
oo
iX
"}
(8,1,2) = {"
iX
oo
oo
Tj
uC
nw
uC
nw
Tj
oo
oo
QB
yv
yv
yv
CD
QB
oo
oo
iX
"}
(9,1,2) = {"
iX
oo
oo
Tj
Tj
Tj
Tj
Tj
oo
oo
oo
QB
xq
CD
nw
nw
QB
oo
oo
iX
"}
(10,1,2) = {"
oo
oo
oo
oo
oo
oo
oo
oo
oo
oo
oo
QB
ri
nw
CD
CD
QB
oo
oo
oo
"}
(11,1,2) = {"
oo
oo
oo
oo
oo
oo
oo
oo
oo
oo
oo
QB
EJ
nw
nw
aF
QB
oo
oo
oo
"}
(12,1,2) = {"
iX
oo
oo
QB
QB
QB
QB
QB
QB
oo
oo
QB
QB
QB
EU
QB
QB
oo
oo
iX
"}
(13,1,2) = {"
iX
oo
oo
QB
Qb
Jl
EK
ix
QB
oo
oo
oo
oo
oo
tm
oo
oo
oo
oo
iX
"}
(14,1,2) = {"
iX
oo
oo
QB
nw
nw
nw
nw
oo
oo
oo
oo
oo
oo
Hv
oo
oo
oo
oo
iX
"}
(15,1,2) = {"
iX
oo
oo
QB
oo
nw
nw
nw
QB
oo
oo
oo
QB
QB
Hv
QB
QB
oo
oo
iX
"}
(16,1,2) = {"
iX
oo
oo
QB
ch
nw
nw
nw
oo
oo
oo
oo
oo
nw
nw
Bv
QB
oo
oo
iX
"}
(17,1,2) = {"
iX
oo
oo
QB
QB
QB
QB
QB
QB
oo
oo
oo
QB
nw
oo
nw
QB
oo
oo
iX
"}
(18,1,2) = {"
iX
oo
oo
oo
oo
oo
oo
oo
oo
oo
oo
oo
QB
nw
nw
nw
QB
oo
oo
iX
"}
(19,1,2) = {"
iX
oo
oo
oo
oo
oo
oo
oo
oo
oo
oo
oo
QB
QB
QB
QB
QB
oo
oo
iX
"}
(20,1,2) = {"
iX
iX
iX
iX
iX
iX
iX
iX
iX
oo
oo
oo
iX
iX
iX
iX
iX
iX
iX
iX
"}
