//MAP CONVERTED BY dmm2tgm.py THIS HEADER COMMENT PREVENTS RECONVERSION, DO NOT REMOVE
"a" = (
/turf/closed/mineral/rogue,
/area/rogue)
"b" = (
/obj/item/clothing/under/roguetown/chainlegs/iron,
/turf/open/floor/rogue/naturalstone,
/area/rogue)
"c" = (
/obj/item/restraints/legcuffs/beartrap/armed/camouflage,
/turf/open/floor/rogue/naturalstone,
/area/rogue)
"f" = (
/turf/closed/mineral/rogue/bedrock,
/area/rogue)
"g" = (
/obj/structure/spider/stickyweb,
/turf/closed/mineral/rogue,
/area/rogue)
"h" = (
/obj/structure/spider/stickyweb,
/turf/open/floor/rogue/naturalstone,
/area/rogue)
"i" = (
/obj/effect/decal/remains/human,
/turf/open/floor/rogue/naturalstone,
/area/rogue)
"j" = (
/mob/living/simple_animal/hostile/retaliate/rogue/spider,
/turf/open/floor/rogue/naturalstone,
/area/rogue)
"k" = (
/obj/item/ingot/iron,
/obj/item/ingot/iron,
/obj/item/ingot/iron{
	pixel_x = 11;
	pixel_y = -5
	},
/obj/item/ingot/iron{
	pixel_y = 4;
	pixel_x = 7
	},
/turf/open/floor/rogue/naturalstone,
/area/rogue)
"l" = (
/obj/item/clothing/suit/roguetown/armor/cuirass/iron,
/turf/open/floor/rogue/naturalstone,
/area/rogue)
"o" = (
/obj/effect/decal/remains/human,
/obj/effect/decal/cleanable/dirt/cobweb,
/turf/open/floor/rogue/naturalstone,
/area/rogue)
"p" = (
/obj/item/clothing/under/roguetown/tights,
/turf/open/floor/rogue/naturalstone,
/area/rogue)
"q" = (
/obj/effect/decal/remains/human,
/obj/effect/decal/cleanable/dirt/cobweb,
/obj/item/restraints/legcuffs/beartrap/armed/camouflage,
/obj/item/clothing/cloak/raincloak/furcloak/black{
	pixel_x = 14
	},
/turf/open/floor/rogue/naturalstone,
/area/rogue)
"u" = (
/obj/item/roguecoin/copper/pile,
/turf/open/floor/rogue/naturalstone,
/area/rogue)
"x" = (
/obj/effect/decal/cleanable/dirt/cobweb/cobweb2,
/turf/open/floor/rogue/naturalstone,
/area/rogue)
"y" = (
/obj/item/reagent_containers/food/snacks/rogue/bun_grenz{
	pixel_x = 14;
	pixel_y = 4
	},
/turf/open/floor/rogue/naturalstone,
/area/rogue)
"B" = (
/turf/open/floor/rogue/naturalstone,
/area/rogue)
"C" = (
/mob/living/simple_animal/hostile/retaliate/rogue/spider,
/obj/structure/spider/stickyweb,
/turf/open/floor/rogue/naturalstone,
/area/rogue)
"E" = (
/obj/structure/spider/stickyweb/solo,
/turf/open/floor/rogue/naturalstone,
/area/rogue)
"F" = (
/mob/living/simple_animal/hostile/retaliate/rogue/spider,
/obj/effect/decal/cleanable/dirt/cobweb,
/obj/item/storage/belt/rogue/pouch/coins/mid,
/turf/open/floor/rogue/naturalstone,
/area/rogue)
"G" = (
/obj/item/roguestatue/iron,
/turf/open/floor/rogue/naturalstone,
/area/rogue)
"H" = (
/obj/structure/spider/stickyweb,
/mob/living/simple_animal/hostile/retaliate/rogue/spider,
/turf/open/floor/rogue/naturalstone,
/area/rogue)
"K" = (
/obj/item/storage/belt/rogue/leather/cloth,
/turf/open/floor/rogue/naturalstone,
/area/rogue)
"L" = (
/obj/effect/decal/cleanable/dirt/cobweb,
/turf/open/floor/rogue/naturalstone,
/area/rogue)
"N" = (
/obj/effect/landmark/ambush,
/turf/open/floor/rogue/naturalstone,
/area/rogue)
"P" = (
/mob/living/simple_animal/hostile/retaliate/rogue/spider,
/obj/effect/decal/remains/human,
/turf/open/floor/rogue/naturalstone,
/area/rogue)
"Q" = (
/obj/item/clothing/suit/roguetown/shirt,
/obj/item/clothing/suit/roguetown/shirt,
/obj/item/clothing/suit/roguetown/shirt,
/obj/item/clothing/suit/roguetown/shirt/rags,
/turf/open/floor/rogue/naturalstone,
/area/rogue)
"R" = (
/obj/item/clothing/suit/roguetown/shirt/dress/gen/black,
/obj/item/clothing/cloak/apron/waist{
	pixel_x = 14;
	pixel_y = -8
	},
/turf/open/floor/rogue/naturalstone,
/area/rogue)
"S" = (
/obj/structure/spider/stickyweb,
/obj/structure/spider/stickyweb,
/turf/open/floor/rogue/naturalstone,
/area/rogue)
"T" = (
/obj/effect/decal/remains/human,
/obj/structure/spider/stickyweb/solo,
/turf/open/floor/rogue/naturalstone,
/area/rogue)
"U" = (
/obj/item/clothing/suit/roguetown/shirt/grenzelhoft{
	pixel_x = -4;
	pixel_y = 19
	},
/obj/item/clothing/under/roguetown/grenzelpants{
	pixel_x = 10
	},
/obj/item/clothing/shoes/roguetown/grenzelhoft{
	pixel_x = -12;
	pixel_y = -13
	},
/turf/open/floor/rogue/naturalstone,
/area/rogue)
"V" = (
/obj/effect/decal/cleanable/dirt/cobweb/cobweb2,
/obj/item/clothing/head/roguetown/helmet/skullcap/grenzelhoft{
	pixel_y = -15
	},
/turf/open/floor/rogue/naturalstone,
/area/rogue)
"W" = (
/obj/effect/decal/remains/human,
/obj/effect/decal/cleanable/dirt/cobweb,
/obj/structure/spider/stickyweb/solo,
/turf/open/floor/rogue/naturalstone,
/area/rogue)
"Y" = (
/obj/effect/decal/remains/human,
/turf/closed/mineral/rogue,
/area/rogue)
"Z" = (
/turf/open/transparent/openspace,
/area/rogue)

(1,1,1) = {"
f
f
f
f
f
f
f
f
B
B
B
f
f
f
f
f
f
f
f
f
"}
(2,1,1) = {"
f
B
B
B
B
B
B
B
B
B
B
B
B
B
B
B
B
B
B
f
"}
(3,1,1) = {"
f
B
B
B
B
B
B
B
a
B
a
a
a
B
B
B
B
a
B
f
"}
(4,1,1) = {"
f
B
a
a
Y
a
B
a
Y
B
B
B
B
B
a
a
B
a
B
f
"}
(5,1,1) = {"
f
B
B
a
q
B
B
a
o
B
a
B
a
a
a
a
a
B
B
f
"}
(6,1,1) = {"
f
a
B
a
R
a
B
a
a
B
a
B
a
W
a
a
B
B
B
f
"}
(7,1,1) = {"
f
B
B
a
K
a
B
B
B
B
B
N
a
T
a
a
a
B
B
f
"}
(8,1,1) = {"
f
B
B
B
B
B
B
a
a
h
a
B
B
B
B
B
c
B
B
f
"}
(9,1,1) = {"
B
B
B
a
a
B
B
a
L
h
a
a
h
a
B
B
a
B
B
B
"}
(10,1,1) = {"
B
B
B
a
L
B
B
a
a
h
H
g
h
a
x
a
a
a
B
B
"}
(11,1,1) = {"
B
B
B
a
B
a
B
B
a
V
y
U
H
g
a
a
h
B
B
B
"}
(12,1,1) = {"
f
B
B
B
B
c
a
B
a
a
h
h
h
B
B
B
h
g
B
f
"}
(13,1,1) = {"
f
B
B
a
i
B
B
B
h
S
S
j
E
i
h
a
a
B
B
f
"}
(14,1,1) = {"
f
B
B
a
a
Q
p
B
a
a
h
g
h
j
h
h
a
a
B
f
"}
(15,1,1) = {"
f
B
B
B
c
B
B
B
a
F
h
H
h
P
h
h
h
h
B
f
"}
(16,1,1) = {"
f
B
a
B
a
B
N
B
a
k
a
b
h
a
h
j
a
B
B
f
"}
(17,1,1) = {"
f
B
a
B
B
B
B
B
a
H
G
l
h
h
h
B
a
a
B
f
"}
(18,1,1) = {"
f
B
B
a
B
B
B
B
a
g
g
g
g
g
g
g
B
B
B
f
"}
(19,1,1) = {"
f
a
B
B
B
a
a
B
B
B
B
B
B
B
B
B
B
a
B
f
"}
(20,1,1) = {"
f
f
f
f
f
f
f
f
f
B
B
B
f
f
f
f
f
f
f
f
"}

(1,1,2) = {"
f
f
f
f
f
f
f
f
B
B
B
B
f
f
f
f
f
f
f
f
"}
(2,1,2) = {"
f
Z
Z
Z
Z
Z
Z
Z
Z
Z
Z
Z
Z
Z
Z
Z
Z
Z
Z
f
"}
(3,1,2) = {"
f
Z
Z
Z
Z
Z
Z
Z
B
Z
B
B
B
Z
Z
Z
Z
B
Z
f
"}
(4,1,2) = {"
f
Z
B
B
B
B
Z
i
h
Z
Z
Z
Z
Z
B
B
Z
B
Z
f
"}
(5,1,2) = {"
f
Z
Z
B
Z
Z
Z
B
Z
Z
Z
Z
B
B
h
B
B
Z
Z
f
"}
(6,1,2) = {"
f
B
Z
B
Z
h
Z
B
B
Z
Z
Z
B
Z
B
h
Z
Z
Z
f
"}
(7,1,2) = {"
f
Z
Z
B
Z
B
Z
Z
Z
Z
Z
Z
B
Z
B
B
B
Z
Z
f
"}
(8,1,2) = {"
f
Z
Z
Z
Z
Z
Z
B
B
Z
B
Z
Z
Z
Z
Z
Z
Z
Z
f
"}
(9,1,2) = {"
B
Z
Z
B
B
Z
Z
h
Z
Z
B
B
B
B
Z
Z
B
Z
Z
B
"}
(10,1,2) = {"
B
B
Z
h
Z
Z
Z
B
B
Z
Z
Z
h
B
B
B
B
B
Z
B
"}
(11,1,2) = {"
B
B
Z
B
Z
B
Z
Z
h
Z
Z
Z
h
Z
h
h
h
B
Z
B
"}
(12,1,2) = {"
B
Z
Z
Z
Z
Z
B
Z
B
C
Z
Z
C
Z
Z
Z
B
Z
Z
B
"}
(13,1,2) = {"
B
B
Z
B
Z
Z
Z
Z
B
h
B
B
u
Z
B
B
B
Z
Z
B
"}
(14,1,2) = {"
f
Z
Z
h
B
Z
Z
Z
B
h
h
C
B
Z
B
Z
B
B
Z
f
"}
(15,1,2) = {"
f
B
Z
Z
Z
Z
Z
Z
B
Z
B
B
i
Z
B
Z
Z
Z
Z
f
"}
(16,1,2) = {"
f
Z
B
Z
B
Z
Z
Z
B
Z
B
Z
B
Z
B
Z
B
Z
Z
f
"}
(17,1,2) = {"
f
Z
B
Z
Z
Z
Z
Z
B
C
h
Z
C
B
B
Z
B
B
Z
f
"}
(18,1,2) = {"
f
Z
Z
B
Z
Z
Z
Z
B
B
B
B
B
B
B
Z
Z
Z
Z
f
"}
(19,1,2) = {"
f
B
Z
Z
Z
B
B
Z
Z
Z
Z
Z
Z
Z
Z
Z
Z
B
Z
f
"}
(20,1,2) = {"
f
f
f
f
f
f
f
f
B
B
B
B
f
f
f
f
f
f
f
f
"}
