//MAP CONVERTED BY dmm2tgm.py THIS HEADER COMMENT PREVENTS RECONVERSION, DO NOT REMOVE
"a" = (
/area/rogue,
/turf/closed)

(1,1,1) = {"
a
a
a
a
"}
(2,1,1) = {"
a
a
a
a
"}
(3,1,1) = {"
a
a
a
a
"}
(4,1,1) = {"
a
a
a
a
"}

(1,1,2) = {"
a
a
a
a
"}
(2,1,2) = {"
a
a
a
a
"}
(3,1,2) = {"
a
a
a
a
"}
(4,1,2) = {"
a
a
a
a
"}
