"a" = (/turf/closed/mineral/rogue/bedrock,/area/rogue/outdoors/mountains/decap)
"b" = (/turf/closed,/area/rogue/outdoors/mountains/decap)
"c" = (/turf/open/water/cleanshallow,/area/rogue/outdoors/mountains/decap)
"d" = (/turf/open/water/swamp,/area/rogue/outdoors/mountains/decap)
"e" = (/turf/closed/mineral/random/rogue/med,/area/rogue/outdoors/mountains/decap)
"f" = (/mob/living/carbon/human/species/goblin/hell,/turf/open/floor/rogue/dirt,/area/rogue/outdoors/mountains/decap)
"j" = (/obj/structure/fluff/traveltile{aportalgoesto = "decapout"; aportalid = "decapin"; aallmig = "rwfielddecap"},/turf/open/floor/rogue/dirt/road,/area/rogue/outdoors/mountains/decap)
"k" = (/turf/closed/wall/mineral/rogue/craftstone,/area/rogue/outdoors/mountains/decap)
"s" = (/obj/machinery/light/rogue/firebowl/standing,/obj/structure/bars,/turf/open/floor/rogue/dirt/road,/area/rogue/outdoors/mountains/decap)
"u" = (/turf/open/floor/rogue/hexstone,/area/rogue/outdoors/mountains/decap)
"z" = (/obj/structure/portal,/obj/structure/bars,/turf/open/floor/rogue/dirt/road,/area/rogue/outdoors/mountains/decap)
"B" = (/obj/effect/landmark/mapGenerator/rogue/decap{endTurfX = 128; endTurfY = 128},/turf/closed/mineral/rogue/bedrock,/area/rogue/outdoors/mountains/decap)
"D" = (/turf/open/lava,/area/rogue/outdoors/mountains/decap)
"E" = (/obj/structure/bars,/turf/open/floor/rogue/dirt/road,/area/rogue/outdoors/mountains/decap)
"G" = (/obj/machinery/light/rogue/campfire,/turf/open/floor/rogue/dirt/road,/area/rogue/outdoors/mountains/decap)
"I" = (/turf/closed/mineral/random/rogue/high,/area/rogue/outdoors/mountains/decap)
"M" = (/turf/open/floor/rogue/volcanic,/area/rogue/outdoors/mountains/decap)
"S" = (/turf/open/floor/rogue/dirt/road,/area/rogue/outdoors/mountains/decap)
"U" = (/turf/open/floor/rogue/dirt,/area/rogue/outdoors/mountains/decap)
"V" = (/obj/machinery/light/rogue/firebowl/standing,/turf/open/floor/rogue/hexstone,/area/rogue/outdoors/mountains/decap)
"Y" = (/obj/structure/fluff/traveltile{aportalgoesto = "forestdecapin"; aportalid = "forestdecapout"},/turf/open/floor/rogue/dirt/road,/area/rogue/outdoors/mountains/decap)

(1,1,1) = {"
bbbbbbbbbbbbbbbbbbbbbbbbbbbbbbbbbbbbbbbbbbbbbbbbbbbbbbbbbbbbbbbbbbbbbbbbbbbbbbbbbbbbbbbbbbbbbbbbbbbbbbbbbbbbbbbbbbbbbbbbbbbbbbbb
aaaaaaaaaaaaaaaaaaaaaaaaaaaaaaaaaaaaaaaaaaaaaaaaaaaaaaaaaaaaaaaaaaaaaaaaaaaaaaaaaaaaaaaaaaaaaaaaaaaaaaaaaaaaaaaaaaaaaaaaaaaaaaaa
aaeeeeeeeeeeeeeeeeeeeeeeeeeeeeeeeaaaaaaaaaaaaaaaaaaaaaaaaaaaaaaaaaaaaaaaaaaaaaaaaaaaaaaaaaaaaaaaaaaaaaaaaaaaaaaaaaaaaaaaaaaaaaaa
aaDDDDeeeeeeeeeeeeeeeeeeeeeeeeeaaaaaaaaaaaaaaaaaaaaaaaaaaaaaaaaaaaaaaaaaasEEsaaaaaaaeeeeeeeeeeeeeeeeeeeeeeeeeeeeeeeeeaaaaaaaaaaa
aaeeeDDDDDeeeeeeeeeeeeeeeeeeeeaaaaaaaaaaaaaaaaaaaaaaaaaaaaaaaaaaaaaaaaaaaEEEEaaaaaaaeeeeeeeeeeeeeeeeeeeeeeeeeeeeeeeeeaaaaaaaaaaa
aaaaaaaeeeDDDDeeeeeeeeeeeeeeeeaaaaaaaaaaaaaaaaaaSSaaaaaaaaaaaaaaaaaaaaaakzSSEkaaaeeeeeeeeeeeeeeeeeeeeeeeeeeeeeeeeeeeeaaaaaaaaaaa
aaaaaaaeeeeeeDDDDDDDDeeeeeeUUUaaeaaaaaaaaaaaaaaaaSSaaaaaaaaaaaaaaaSaaaaakVuuVkaaaeeeeeeeeeeeeeeeeeeeeeeeeeeeeeeeeeeeeaaaaaaaaaaa
aaaaSSSeeeeeeeeeeeUDDDDDDDDDUDDDDDDDDDDDDDDDDaaaSSSSaSaaaaaaSSSaaaSSaaaakuuuukaeeeeeeeeeeeeeeeeeeeeeeeeeeeeeeeeeeeeeeaaaaaaaaaaa
aaSSSGSeeeeeeeeeeUUUUUUUUUeDDDDDDDDDDDDDDDDDDaaaaaSSaSSaaSSSSSSSSSSSSSSSkuuuukaeeeeeeeeeeeeeeeeeeeeeeeeeeeeeeeeeeeeeeaaaaaaaaaaa
aaYSSSSeeSSSSSSSSSSSSUUUUUUUUUaaaaaaaaUUUUUUDUUUUeeDDeeeDDDDDDDDDDDDDDDDMMMMMMDDDDDDDDDDeeDDDDDDDDDDDDeDeeaaaaeeeeeeeaaaaaaaaaaa
aaYSSSSSSSSSSSSSSSSSSSSSSSSSSSeeeeeeeaUUUUUUDUUUUeeeDeeeeeeDDDDDDDDDDDDMMMMMMMDDDDDDDDDDDDDDDDDDDDDDDDDDeeaaaaeeeeeeeaaaaaaaaaaa
aaSSSeeeeeeeeeeeeUUUSSSSSSSSSSeeeeeeeaUeUeUUDUUUeUeeDeeeeeeDDDDDDDDDDDDMMUUUMMDDDDDDDDDDDDDDDDDDDDDDDDDDDeaaaaeeeeeeeaaaaaaaaaaa
aaaaaaaeeeeeeeeeeUUUSUUUUUUeeeeeeeeeeeUeUUUUDUUUUUeeDeeeeeeDDDDDDDDDDDDDMMUUMMDDDDDDDDDDDDDDDDDDDDDDDDDDDDaaaaeeeeeeeaaaaaaaaaaa
aaaaaaaeeeeeeeeeeUUUSUUUUUUeeeeeeeeeeeUUUUUUDUUUUeeeDDeeeeeDDDDDDDDDDDDMMMUUMMMDDDDDDDDDDDDDDDDDDDDDDDDDeDaaaaeeeeeeeaaaaaaaaaaa
aaaaaaaeeeeeeeeeeUUUSUUUUUeeeeeeeeeeeeUUUUUUDDDDDDDDDDeeeeeDDDDDDDDDDDMMMUUUUUMMMDDDDDDDDDDDDDDDDDDDDDDDDDaaaaeeeeeeeaaaaaaaaaaa
aaaaaaaaeeeeeeeeeUUUSUUUUUeeeeaaaaaaeeUUUUUUeeeUUeUeDDeeeeeDDDDDDDDDDDMMUUUUUUUUMMMDDDDDDDDDDDDDDDDDDDDDDDaaaaeeeeeeeaaaaaaaaaaa
aaaaaaaaeeeeeeeeeUUUSUUUUUeeeaaaaaaaeeeeeeeeeeeeeUUeDDeeDeeDDDDDDDDDMMMUUUUUUUUUUMMMDDDDDDDDDDDDDDDDDDDDDDaaaaeeeeeeeaaaaaaaaaaa
aaaaeeeeeeeeeeeeeUUUSUUUUUeeeaaaaaaeeeeeeeeeeeeeeUUeeDDeDDDDDDDDDDDMMMUUUUUUUUUUUUMDDDDDDDDDDDDDDDDDDDDDDDaaaaeeeeeeeaaaaaaaaaaa
aaeeeeeeeeeeeeeeeUUUSUUUUUeeeaaeeeeeeeeeeeeeeeeeeeeeeeDDeDDDDDDDDDDMMUUUUUcUUUUUUUMMDDDDDDDDDDDDDDDDDDDDDDaaaaeeeeeeeaaaaaaaaaaa
aaeeeeeeeeeeeeeUUUUUSUUeeeeeeaaeeeeeaaeeeeeeeeeeeeeeeeDDeDDDDDDDDMDMUUUUUUUUUUUUUMMMDDDDDDDDDDDDDDDDDDDDDDaaaaeeeeeeeaaaaaaaaaaa
aaDDDDDDeeeeeeeUUUUUSUUUUeeeeaaeeeeeaaeeeeeeeeeeeeeeeeDDDeDDDDDDDMMMUUUUUUUUUUUUUMMDDDDDDDDDDDDDDDDDDDDDDDaaaaeeeeeeeaaaaaaaaaaa
aaeeeeeDDDDDDDDUUUUUSUUUUUUUeaaeeeeeaaeeeeeeeeeeeeeeeeeDDeDDDDDDDDMMMUUUUUUUUUUUMMDDDDDDDDDDDDDDDDDDDDDDDDaaaaeeeeeeeaaaaaaaaaaa
aaeeeeeeeeeeeeDDDDDDDDDDDDDDDDDDDDDDDDDDDDDDDDDDMeeeeeeDDDDDDDDDDDMMMUUUUUUUUUUMMDDDDDDDDDDDDDDDDDDDDDDDDDaaaaeeeeeeeaaaaaaaaaaa
aaeeeeeeeeeeeeeeeUUUSUUUUUUUaaaeeeeaaaMMMMMMMDDDMMeeeeeDDDDDDDDDDDDMMMUUUUUUUUMMMMDDDDDDDDDDDDDDDDDDDDDDDDaaaaeeeeeeeaaaaaaaaaaa
aaeeeeeeeeeeeeeeeeeeSUUUUUUUaaaeeeeaaaeeeeeeMDDDDMeeeeeeDDDDDDDDDDDDIIIIIIIIIIIMDDDDDDDDDDDDDDDDDDDDDDDDDDaaaaeeeeeeeaaaaaaaaaaa
aaaaaaeeeeeeeeeeeeeeSUUSUUUUaaaeeeeaaaeeeeeeMDDDMMeeeeeeDeDDDDDDDDDDIIIIIIIIIIIDDDDDDDDDDDDDDDDDDDDDDDDDDDaaaaeeeeeeeaaaaaaaaaaa
aaaaaaeeeeeeceeeeeUUSSSSSSSSaaaeeeeaaSeeeeeeMMDMMMeeeeeeeDDDDDDDDDDDIIIIIIIIIIIDDDDDDDDDDDDDDDDDDDDDDDDDDDSaaaeeeeeeeaaaaaaaaaaa
aaaaaaeeeeccccceUUUUUUUSeeeaaaaeeeeaSSeeeeeeMDDMMMeeeeeeeeDDDDDDDDDDIIIIIIIIIIIDDDDDDDDDDDDDDDDDDDDDDDDDDDSSSaeeeeeeeaaaaaaaaaaa
aaaaaaeeeeecccceUUUUUUUSUUUaaaaeeeeeeaeeeeeeMDDDDDDDDDDDDDDDDDDDDDDDIIIIIIIIIIIDDDDDDDDDDDDDDDDDDDDDDDDDDDSSSaeeeeeeeaaaaaaaaaaa
aaaaaaeeeeeecccUUUUUUUUSUUUaaaaeeeeeeeeeeeeeMDDMeeeeeeeeeeDDDDDDDDDDIIIIIIIIIIIDDDDDDDDDDDDDDDDDDDDDDeeeeeaaaaeeeeeeeaaaaaaaaaaa
aaaaeeeeeeeUccUUUUUUUUUSUUUaaaaaaaaaaeeeeeeeMDMMeeeeeeeeeeDDDDDDDDDDIIIIIIIIIIIDDDDDDDDDDDDDDDDDDDDeeeeeeeaaaaeeeeeeeaaaaaaaaaaa
aaaaeeeeeeUeUUUUUUUUUUUSUUUaaaaaaaaaaaeeeeeeMMMeeeeeeeeDeeDDDDDDDDDUIIIIIIIIIIIDDDDDDDDDDDDDDDDDDDDDeeDeeDaaaaeeeeeeeaaaaaaaaaaa
aaaaeeeeeUeeUUUUUUUUUUUSUUUaaaaaaaaaaaeeeeeeMMeeeeeeeeeDeeDDDUUUUUUUIIIIIIIIIIIDDDDDDDeDeDeDeeDeDeeeeeeeeeaaaaeeeeeeeaaaaaaaaaaa
aaeeeeeeeUeeUUUUUUUUUUUSUUUaaaaaaaaaaaeeeeeMMeeeeeeeeeDDeeDDUUeeUUUUIIIIIIIIIIIDDDDeeeeeeeeeeeeeeUUUUUeUeeeeeeeeeeeeeeaaaaaaaaaa
aaeeeeeeeUUeeeUUUUUUUUUSSSSeeeeeeeeeeeeeeeeMMeeeeeeeeeDDeeDDDUeeUUUUIIIIIIIIIIIDDDDDeeeeeeeeeeeeUUUUUUUUUUeeeeeeeeeeeeaaaaaaaaaa
aaeeeeeeUUeeeeUUUUeeeUUSSSSeeeeeeeeeeeeeeeeMMeeeeeeeeeDDeDDDeeeUUUUUUUUUUeUUeeeDDDDDeeeeeeeeeeeeUeUUUUUUUUeeeeeeeeeeeeaaaaaaaaaa
aaeeeeeUUUeeeeUUUUeeeUUSSSSeeeeeeeeSSSeeeeeeMeeeeeeeeeDDDDeeeeeUUUIIIIIIIIIDeeeeDDDeDeeeeeeeeeeeeUUUUUUUUUeeeeeeeeeeeeaaaaaaaaaa
aaeeeeeeeeeeUUUUUUeeeUUSUUUeeaaaSSSSSSeeMMMMMeeeeeeeeeDDDDeeeeeUUUIIIIIIIIIDDeeeDDDDDDeeeeeeeeeeUUUUUUUUUUeeeeeeeeeeeeaaaaaaaaaa
aaDDDDDDDDDDUUUUUUeeeeeSeeeeeaaaaaaaaaeeMMMMMeeeeeeeeDDDDeeeeeUUUeIIIIIIIIIeDeeeeDDeDDeeeeeeeeeUUUUUUUUUUUeeeeeeeeeeeeaaaaaaaaaa
aaeeeeeeeUUDDDDDDUeeeeeSeeeeDDDDDDDDDDDDDDDMMeeeeeeeeeDDDeeeeUUUUeIIIIIIIIIUeeUDeDDDDDDeeeeeeeeUeUUUUUUUUUeeeeeeeeeeeeaaaaaaaaaa
aaaaaaeeeUUUUUUUDDDDDDDDDDDDDDDDDDDDDDDDDDDDMeeeeeeeeDDDDeUUeUUUUUIIIIIIIIIUUeUUeeDDDDDDeeeeeeeUUUUUUUUUUeeeeeeeeeeeeeaaaaaaaaaa
aaaaaaeeeUUUUUUUUUUeeeUSeeeeeaaaaaaaaaMMMMDDDDDDDDDDDDDDDeUUUUeUUUIIIIIIIIIUUUUUDDDDDDDDeeeeeeeeeeUUeUUUMMeeeeeeeeeeeeaaaaaaaaaa
aaaaaaeeeUUUUUUUUUUUUUUSUeeeeaaaaaaaaaMeMMDDMMeeeeeeeDDDUeUeUUUUUUIIIIIIIIIUUUUUUeDDDDDDDeeeeeeeeeeUUeMMMMeeeeeeeeeeeeaaaaaaaaaa
aaaaaaeeeUUUUUUUUUUUUUUSSSeeeeeeeeeeeeeeMMDMMMeeeeeDDDDDUUUUUUUUUUIIIIIIIIIUUUUUUUUeDDDDDeeeeeMMMMMMMMMeeeeeeeeeeeeeeeaaaaaaaaaa
aaaaaaeeeUUUUUUUUUUSSSSSSSeeeeeeeeeeeeeeMMMMMeeeeeeDDDDDUUUUUUUUUUIIIIIIIIIUUUUUUUUeDDDDDDeeeMMeeeeeeeeeeeeeeeeeeeeeeeaaaaaaaaaa
aaeeeeUUUUUUUUUUUUUUUUUSSSeeeaaaaaaaaaeeMMMMeeeeeeeDDDDDDUUUUUUUUUIIIIIIIIIUUUUUUUUUDDDDDDeeMMMMeeeeeeeeeeaaaaaaaaaaaaaaaaaaaaaa
aaeeeeUUUUUUUeeeUUUUUUUSUeeeeaaaaaaaaaDDDDDDDDDDDDDDDDDDDeUUeUUUUUIIIIIIIIIUUUUUUUUUDDDDDDDeMDeMeeeeeeeeeeaaaaaaaaaaaaaaaaaaaaaa
aaDDDDDDDDDDDDeeeUeeeeeSeeeeDDDDDDDDDDDeeeMUeeeeeeeeeeDDeeUUUUUUUUIIIIIIIIIIIIIIUUUUDDDDDDDMMDDeeeeeeeeeeeSaaaaaaaaaaaaaaaaaaaaa
aaeeeeUUUeeeeDDDDDDDDDDDDDDDDDDDDDDDDDDeeUUUeeeeeeUeUUDDDeUUUUUUUUIIIIIIIIIIIIIIUUUeDeDDDDDMDDDDeeeeeeeeDeaaaaaaaaaaaaaaaaaaaaaa
aaeeeeUUUIIIIIIIeUeIIIISIIIIIIIIIIIIIaeeeUUeUeeeeUUeUUDDDDUUUUUUUUIIIIIIIIIIIIIIUeeeDeeDDDDMDeDDeeeeeeeDDeaaaaaaaaaaaaaaaaaaaaaa
aaeeeeUUUIIIIIIIUUUIIIISIIIIIIIIIIIIIaUeUUUUUUUUUUUUUUDDDDeUUUUUUUeIIIIIIIIIIIIIUeeDDeeDDDDMDDeeDDeeeeeDDDaaaaaaaaaaaaaaaaaaaaaa
aaeeeeeUUIIIIIIIUUUIIIISIIIIIIIIIIIIIeeeaaaaaaaaaaaSSSSDDDaaaaaaSSSIIIIIIIIIIIIIaaaDDaaSSaeeeaaaaaaaaaaDDaaaaaaaaaaaaaaaaaaaaaaa
aaeeeeeUUIIIIIIIUUeIIIISIIIIIIIIIIIIIeeeaaaaaaaaaaaSSSaDDDaaaaaSSIIIIIIIIIIIIIIIIIIDDaaaaaeeeaaaaaaaaaaDDaaaaaaaaaaaaaaaaaaaaaaa
aaeeeeeUUIIIIIIIeUUIIIISIIIIIIIIIIIIIeeeaaaaaaDDDDDDDDDDDDaaaaaSSIIIIIIIIIIIIIIIIIIDDaaaaaeeeaaaaaaaaaaDDaaaaaaaaaaaaaaaaaaaaaaa
aaaeeeeUUIIIIIIIUUUUSSSSIIIIIIIIIIIIIeeeaaaaaaDDDDDDDDDDDDDDaaaSSIIIIIIIIIIIIIIIIIIDDaaaaaeeeaaaaaaaaaaDDaaaaaaaaaaaaaaaaaaaaaaa
aaaeeeeUUIIIIIIIUUUUSUUUIIIIIIIIIIIIIDDDDDDDDDDDDaaSeeeeaDDDaaaaSIIIIIIIIIIIIIIIIIIDDaaaaaeeeaaaaaaaaaaDDaaaaaaaaaaaaaaaaaaaaaaa
aaaeeeeUUeUUUUUUUUUUSUeeeeeeeeDDeaaaaDDDDDDDDDDDDaaeeeeeaDDDaaaaaIIIIIIIIIIIIIIIIIIDDaaaaaaeeaaaaaaaaaaDDaaaaaaaaaaaaaaaaaaaaaaa
aaaeeeeUUUUUUUUUUUUUSSSSUUeeeDDeeaaaaDDDDDDDDDDDDaaeeeeeaDDDDDaaaIIIIIIIIIIIIIIIIIIDDaaaaaaeeaaaaaaaaaaDDaaaaaaaaaaaaaaaaaaaaaaa
aaaeeeeUUUUeUUeeeeUUUUUSUUUDDDeeeaaaaaaDDDDaaaaaaaaeeeeeaaDDDDaaaIIIIIIIIIIIIIIIIIIDDaaaaaeeeaaaaaaaaaaDDaaaaaaaaaaaaaaaaaaaaaaa
aaaaaaeUUUUUUUeeeeUUUUUSUUDDeeeeeeeeaaDDDDDaaaaaaaeeeeeeaaaDDDUSeIIIIIIIIIIIIIIIIIIDDaaaaaeeeeeeaaaaaaaDDaaaaaaaaaaaaaaaaaaaaaaa
aaaaaaeeUUUUUUeeeeUUUUUSDDDUeeIIIIIIaaaDDDDaaaaaaaaeeeeeaaaUUDUSeIIIIIIIIIIIIIIIIIIDDaaaaaeeeeeeaaaaeeeDDaaaeeeaaaaaaaaaaaaaaaaa
aaaaaaeeUUUUUUeeeeeeeDDDDUUIIIIIIIIIeeeDeaaaaaaaaaaaeeeeaaaUUDUSaIIIIIIIIIIIIIIIIIIaDaeeeaaeeeeeaaaaeeeeDeeeaaeeeeeeeaaaaaeeeeea
aaaaaaUUUUUUUUUeeeeDDDUSUUUIIIIIIIIIeeDeeaaaaaaaaaeeeeeeeeeUUDDSUIIIIIIIIIIIIIIIIIIeDeeeeaaaaeeeeeeeeeeUDDUUUUUUUUUUUUeeeeeeeeea
aaaaaaUUUUUeeeUeeDDDeeUSUUUIIIIIIIIIeDDeeIIIIIIIIIIIIIIeeeeUUUDSUUUeUUUUUUSSSSSSSSSDDSSSSUUUUUUeeUUUUUeUUDUUUUUUUUUUUUeeeeeeeeea
aaaaaaUUUUUeeeeDDDeeeeUSUUUIIIIIIeeeeDeeeIIIIIIIIIIIIIIeeeeUUUDSUUUUUUUUUUSSUUUUUUUDUUUUSUUUUUUeeUUUUUUUUDUUUUUUUUUUUUeeeeeeeeea
aaaaaaUUUUUUeDDDeeUeIIIIIIIIIIIIIeeeDDeeeIIIIIIIIIIIIIIIIIIUUUDSUUUUUUUUUUSSUUUUUUUDUUUUSUUUUUUUUUUUUUUUUDUUUUUUUUUUUcUUUeeeeeea
aaaaaaUUUUUDDDeeeeUeIIIIIIIIIIIIeeeDDeeeUIIIIIIIIIIIIIIIIIIUUUDSUUUUUUUUUUSUUUUUUUDDUUUUSUUUUUUUUUUUUUUUUDUUUUUUUUUUUcUUUUUUeeea
aaaaaaUUUDDDUIIIIIIIIIIIIIIIIIIIeeeDeeUUeeUUSIIIIIIIIIIIIIIUUUDSUUUUUUUUUUSeUUUUUUDUUUUUSUUUUUUUUUUUUUUUUDUUUUUUUUUccccccUUUeeea
aaeeeeUUDDUUUIIIIIIIIIIIIIIIIIIIeeDDeUUUUUUeSIIIIIIIIIIIIIIUUUDSSSSSSSSSSSSeUUeeeUDUUUUUSUUUUUUUUUUUUUUUUDUUUUUUUUUUUccccUUUeeea
aaeeeeUDDUUUeIIIIIIIIIIIIIIIIIIIeDDeUUeUUUUUSIIIIIIIIIIIIIIUUUDUUUSSUUUUUUUUUeeeeUDUUUUUSUUUUUUUUUUUUUUUUDUUUeUUUUUUUccUUUeeeeea
aaeeeDDDUUUUeIIIIIIIIIIIIIIIIIeeDDeUUUUUUUUeSIIIIIIIIIIIIIIUUUDUUUSSUUUUUUUUUeeeeDDeIIIIIIIIIIIIIIIIIIIIUDUUUeUUUUUUUUcUUeeeeeea
aaeeDDeUUUUUUIIIIIIIIIIIIIIIIIeeDeeUUUUUUUeeSIIIIIIIIIIIIIIUUUDUeeSSUUUUUUeeeeeeeDeeIIIIIIIIIIIIIIIIIIIIUDUUUeUUUUUUUUUUUeeeeeea
aaeDDeeUUUUUUIIIIIIIIIIIIIIIIIeeDeeUUUUUUUeeSIIIIIIIIIIIIIIUUUDUeeSSeeeUeeeeeeeeeDeeIIIIIIIIIIIIIIIIIIIIUDUUUeeUUUUUeeeeeeeeeeea
aaDDeeeeeUUUUIIIIIIIIIIIIIIIIIeDDUUUUUUUUUUUSUUUIIIIIIIIIIIUUUDUeeSSeeeUUeeUUeeeeDeeIIIIIIIIIIIIIIIIIIIIUDUUUeeUUUUUUUeeeeeeeeea
aaeeeeeeeUUUUIIIIIIIIIIIIIIIIIUDUUUeeeeUeUSSIIIIIIIIIIIIIIIIeeDeIIIIIIIIIIIIIeeeeDeeIIIIIIIIIIIIIIIIIIIIUDeeeeeUUUUUeeeeeeeeeeea
aaeeeeeeeUUUUIIIIIIIIIIIIIIIIIeDeUeeeeeUUUSUIIIIIIIIIIIIIIIIeUDeIIIIIIIIIIIIIeeeDDeeIIIIIIIIIIIIIIIIIIIIUDeeeeeUUUeeeeeeeeeeeeea
aaeeeeeeeUUddUUUUUSUIIIIIIIIeeeDUUUeeeeeUUSUIIIIIIIIIIIIIIIIeUDeIIIIIIIIIIIIIeeeDeeeIIIIIIIIIIIIIIIIIIIIeDDeeeeeeUeeeeeeeeeeeeea
aaeeeeeeeeUddUdUfUSUIIIIIIIIeeDDUUeeeeeeUUSUIIIIIIIIIIIIIIIIeUDeIIIIIIIIIIIIIeeeDeeUIIIIIIIIIIIIIIIIIIIIeeDeeeeeeUeeeeeeeeeeeeea
aaeeeeeeeeUdUUdUUUSUIIIIIIIIeUDUUeeeeeeeeUSeIIIIIIIIIIIIIIIIeeDeIIIIIIIIIIIIIeeeDeUUIIIIIIIIIIIIIIIIIIIIeeDUUeeeeUeeeeeeeeeeeeea
aaeeeeeeeeUdUUUUfUSUIIIIIIIIUUDeeeeeeeeUUUSUIIIIIIIIIIIIIIIIUUDUIIIIIIIIIIIIIeeeDeUUIIIIIIIIIIIIIIIIIIIIeeDDUeeeeUeeeeeeeeeeeeea
aaaaeeeeUUddUUddUUSUIIIIIIIIeeDeeeeeeeeUUUSUUUUUUUUUUUUUUUSSSSDSIIIIIIIIIIIIIeeeDeeUIIIIIIIIIIIIIIIIIIIIeeUDDUUeeUeeeeeeeeeeeeea
aaaaeeddddddUUddUUSUIIIIIIIIeDDeeeeeeUUUUUSUUUUUUUUUIIIIUUSUUUDUIIIIIIIIIIIIIeeeDeeeIIIIIIIIIIIIIIIIIIIIeeUUDUUeeUeeeeeeeeeeeeea
aaaadedddUUUUdddUUSUIIIIIIIIeDeeeeeeeUUUUUSUUIIIIIIIIIIIIISUUeDDIIIIIIIIIIIIIeeeDeeIIIIIIIIIIIIIIIIIIIIIUUUUDDUUeUeeeeeeeeeeeeea
aaaeeedeeUUUUdddUUSUUUUUUUUUUDUUUUUSSSSSSSSUUIIIIIIIIIIIIISUUeDDIIIIIIIIIIIIIeeDDeeIIIIIIIIIIIIIIIIIIIIIUUUUUDUUUUUeeeeeeeeeeeea
aaaeeddeeeUUUUUUUUSSSSSSSSSSDDSSSSSSSSeeeeeeUIIIIIIIIIIIIISUUeDDIIIIIIIIIIIIIeeDeeeIIIIIIIIIIIIIIIIIIIIIUUUUUDDUeeeeeeeeeeeeeeea
aaeeedddeeeSSSSSSSSSUUeeeeeeDeUUUUUUUSUeeeeeUIIIIIIIIIIIIISUUeeDIIIIIIIIIIIIIeeDeeeIIIIIIIIIIIIIIIIIIIIIUUUUUUDUeeeeeeeeeeeeeeea
aaeeeeeeeeeSUUUUUUUUUeUeeUUUDeeeeeeeeSUeeeeeUIIIIIIIIIIIIISUUeeDeeIIIIIIIIIIIeeDeeeIIIIIIIIIIIIIIIIIIIIIUUUUUUDDeeeeeeeeeeeeeeea
aaeeeeeeeUeSUeeeeeeeUeUeUUUUDeUUeeeeeSUeeeeeUeUUIIIIIIIIUUSUUeeDeeIIIIIIIIIIIeeDeeeIIIIIIIIIIIIIIIIIIIIIUUUUUUUDeeeeeeeeeeeeeeea
aaeeeeeeeeeSUeeeeeUeeUUUUeUeDUUeeeeeeSUeeeeeUUUUIIIIIIIUUUSUUUUDUIIIIIIIIIIIIIeDeeUIIIIIIIIIIIIIIIIIIIIIUUUUUUUDDeeeeeeeeeeeeeea
aaeeeeeeeUeSeeeeeeUUUUUUeUUeDeeeeeeeeSUeeeeUUUUUIIIIIIIUUUSUUUDDUIIIIIIIIIIIIIeDeeUIIIIIIIIIIIIIIIIIIIIIUUUUUUUUDeeeeeeeeeeeeeea
aaaaaeeeeeUSeUeeeeeeeeUUeeeDDeeeeeeeeSUeeeeUeUUUIIIIIIIUUUSUUUDUUIIIIIIIIIIIIIeDeeeIIIIIIIIIIIIIIIIIIIIIUUUUUUUUDDeeeeeeeeeeeeea
aaaaaeeeeeUSSSSeeeeeeeUUeeeDUeeeeeeeeSUeeeeUUeUUeeeeeeeUUUSUUUDUUIIIIIIIIIIIIIeDeeUIIIIIIIIIIIIIIIIIIIIIUUUUUUUeeDDeeeeeeeeeeeea
aaaaaeeeeeUUeeSeeeeeUeeeeeeDUeeeeeUeeSUeeeeeUeeUUUeeeeeUUUSSSUDUUIIIIIIIIIIIIIeDeUUIIIIIIIIIIIIIIIIIIIIIUUUUUUUeeeDeeeeeeeeeeeea
aaaaaeeeeeUUeeSeeeUUUeeeeeeDUeeeeeUUeSUeUUUUUUUUUUeeeeeeUUUUSUDUUIIIIIIIIIIIIIeDeUUIIIIIIIIIIIIIIIIIIIIIUUUUUUUeeeDDeeeeeeeeeeea
aaaaaeeeeeeUeeSeeeeUUeeeeeeDUeeeUeeUUSUUUeUUUUUUUUeeeeeeeUUUSUDUUIIIIIIIIIIIIIeDUUeIIIIIIIIIIIIIIIIIIIIISSSSSSUUeeeDeeeeeUUeeeea
aaaaaeeeeeeUUUSeeeeeeeeeeeDDUeeeUeeeeSSSUUUUUUUUcUeeeeeeeeeeSUDUUIIIIIIIIIIIIIeDUeeIIIIIIIIIIIIIIIIIIIIIUeeeUSUUeeeDDeeeeUUeeeea
aaaaaeeeeeeUUUSeeeeeeeeeeUDeUeeeUeeeeeUSUUUUUccccUeeeeeeeeeeSeDeeIIIIIIIIIIIIIeDSSSIIIIIIIIIIIIIIIIIIIIIIeeeUSUUeeeeDDUUUUUeeeea
aaaaaeeeeeeeUUSeeeeeeUUUUUDSSSSSSSSSSSSSUUUUUccccUeeeeeeeeeeSeDeeIIIIIIIIIIIIISDSUUIIIIIIIIIIIIIIIIIIIIIIeeeUSUUeeeeeDUUUUUeeeea
aaaaaeeeeeeeUUSUUeeUeUUUUDDSUUUUeeeeUUUUUUUUUccccUeeeUUeUeeeSeDDeIIIIIIIIIIIIIeDeeUIIIIIIIIIIIIIIIIIIIIIIeeeUSUUeeeeeDUUUUUeeeea
aaaaaeeeeeeeeUSUUeeUeUUUUDUSUUUeeeeeeeUUUUUUUUccUUeeeUeeUUeUSUeDeIIIIIIIIIIIIIeDeeeeIIIIIIIIIIIIIIIIIIIIIeeeUSUUeeeeeDUUUUUUUeea
aaaaaeeeeeeeeUSUUeeUUUUUUDUSSSSSSeeeeeeeeeeUUUccUUeeeUeeUUSSSUUDIIIIIIIIIIIIIIUDUUUeIIIIIIIIIIIIIIIIIIIIIeeeUSUUeeeeeDDUUUUUUeea
aaaaaeeeeeeeeeSeeeeUUUUUUDUUUUUUSSSSSeeeeeeeeUUUUUeeeUUeUeSUUeeDIIIIIIIIIIIIIISDUUUeIIIIIIIIIIIIIIIIIIIIIeeeUSSSSSSSSSDDUUUUUeea
aaaaaeeeeeeeeeSSSeeeUUUUUDUUUUUUUUUUSeeeeeeeeUeeUUeeeeUUUUSeeeeDIIIIIIIIIIIIIIUDDUUeIIIIIIIIIIIIIIIIIIIIIeeeUUUUUUUeeUUDUUUUUeea
aaaaaeeeeeeeeeeeSSSSSSSUUDUUUUUUUUUUSeeeeeeeeUeeeeeeeeeeUUSUUeeDIIIIIIIIIIIIIIUSDUUeIIIIIIIIIIIIIIIIIIIIIeeeUUUUeeeeeeUDUUUUUeea
aaaaaeeeeeeeeeeeUUUUUUSUUDUUUUUUUUUUSSSSSSSSSSUeeeeeeeeeUeSUeeeDIIIIIIIIIUUUUUUSDUUeIIIIIIIIIIIIIIIIIIIIIeeeUUUUeeeeeUUDUUUUUeea
aaaaaeeeeeeeeeeUUUUUUUSUDDeUUUUUUUUUUUUUUUUUUSUUUUeeeeeeeeSUUeUDIIIIIIIIIUUUUUUSDUUeIIIIIIIIIIIIIIIIIIIIISSSSSUUeeeeeUUDUUUUUeea
aaaaaeeeeeeeeUUeeeeUUUSUDUUUUUUUUUUUUeeeeeeeeSUUUUeeeeeeeeSUUUUDIIIIIIIIIUUUUUUSDUUeIIIIIIIIIIIIIIIIIIIIIeeeUSUUeeeeeUUDUUUUUeea
aaaaaeeeeeeeeUeeeeeUUUSUDUUUUUUUUUUUUeeeeeeUUSUUUUUeeeUUUUSUUUUDUUUIIIIIIUUUUUUSDUUUIIIIIIIIIIIIIIIIIIIIIeeeUSSSSSSSSSSDUUUeeeea
aaaaaeeeeeeUUeeeeeeUUUSUDUUUUUUUUUUUUeUUeeeUUSSSSSSSSeUUUUSUUUUDDUUIIIIIIUUUUUUSDSSSIIIIIIIIIIIIIIIIIIIIIeeeUSUUUUUUUUeDeUUUeeea
aaaaaeeeeeeUeeeeeeeUUUSUDUUUUUUUUUUUUeeUUeeeUeeUUUUUSeUUUUSUUUUUDUUIIIIIIUUUUUUUDUUUIIIIIIIIIIIIIIIIIIIIIeeeUSUUeeeeeeeDeUUUeeea
aaeeeeeeeeeUeeeeeeeUUUSUDUUUUUUUUUUUUeeeUUeeUUUUUUUeSSSSSSSUUUUUDUUIIIIIIeeUUUUUDUUUeeIIIIIIIIIIIIIIIIIIIeeeeSUeeeeeeeeDeUUUeeea
aaeeeeeeeeeUUeeeeeeUUUSUDUUUUUUUUUUUUeeUUeUUUUeUUUUeUeUUUUUUUUUUDUUeeeeeeeeUUUUUDUUUeeIIIIIIIIIIIIIIIIIIIeeeUSUeeeeeeeeDeeeeeeea
aaeeeeeeeeUUUeeeeeeUUUSUDUUUUUUeUUUUUUUeUeUUeUeUUeeeeeUUUUUUUUUUDUUeeeeeeeeUUUUUDUeeeeIIIIIIIIIIIIIIIIIIISSSSSUUUeeeeeDDeeeeeeea
aaeeeeecccUeeeeeeeeUUUSUDUUUUUUeeUUUUUUUUUUeeUeUUeeeeeeUUUUUUUUUDUUUUeeeeeeUUeUUDUeeeeIIIIIIIIIIIIIIIIIIIUUUeUUeeeeeeeDeeeeeeeea
aaeeecccccUeeeeeeeeUUUSUDeeeeeeeeUUUUUUeeeeeeUeUUUeeeeeUUUUUUUUUDUUUUeeeeeeUUeeeDUUUUUIIIIIIIIIIIIIIIIIIIIIIIIIeeeeeeeDeeeeeeeea
aaeeeececUUeeeeeeeeUUUSUDeeUUeeeeUUUUUUeeeeUeUeeUUeeeeeeeeUUUUeeDeeeeeeeeeeUUeeeDUUUeUIIIIIIIIIIIIIIIIIIIIIIIIIeeeeeeeDeeeeeeeea
aaeeeeeecUUeeeeeeeeeeeSUDeeeUUUUUUUUUUUUeeeUUUUeUUeeeeeeeeUUUUeeDDeeeeeeeeeUUeeDDeeUUUIIIIIIIIIIIIIIIIIIIIIIIIIeeeeeeDDeeeeeeeea
aaeeeeeeeeeUUeeeeeeeeUSUDDeeeeeUUeeeeUUUUeeUeUUeUUUUUUeeeeUUUUeeeDeeeeeeeeeUUeeDeeeeeeIIIIIIIIIIIIIIIIIIIIIIIIIeeeeeDDeeeeeeeeea
aaeeeeeeeeeeUeeeeeeSSUSUUDDDeeeUUeeeeeUUUeeUUUUUUUUUUUUUUUUUUUUUUDUUUUUUUUUUUeeDeeeeeeeeIIIIIIIIIIIIIIIIIIIIIIIeeeeeDeeeeeeeeeea
aaaaeeeeeeeeeUUUeeeSSUSUUUUDDeeUUUUeUUeUUeeUUUUUUUeeeeeeeeeeeeeeeDeeeeeeeeeUUeeDeeeeeeeeIIIIIIIIIIIIIIIIIIIIIIIeeeeDDeeeeeeeeeea
aaaaaaeeeeeeeeUUUUUSSUSUUUUUDDeeeeUUUUeeUeeUUUUUUUeeeeeUUUUUUUeeeDeeeeeeeeeeeeeDeeeeeeeeIIIIIIIIIIIIIIIIIIIIIIIeeeeDeeeeeeeeeeea
aaaaaaaaaaaaaaaaaaSSSSSSSSSUeDeeeeUUUUUUUUeUUUUUUUeeeeeUUUUUUUeeeDeeeeeeeeeeeeeDeeeeeeeeIIIIIIIIIIIIIIIIIIIIIIIeeeDDeeeeeeeeeeea
aaaaaaaaaaaaaaaaaaSSSSSGSSSSSDDeeeeUUeeeeeeUUUUUeeeUUUUUUUUUUUeeeDeeeeeeeeeeeeeDeeeeeeeeIIIIIIIIIIIIIIIIIIIIIIIeeeDeeeeeeeeeeeea
aaaaaaaaaaaaaaaaaaSSSSSSSSSSaaDDeeeeeeeeeeeeeeeeUUUUUUUUUUUUUUeeeDeeeeeeeeeeeeeDeeeeeeeeeeeeeeeeeeeeeeeeeeeeeeeeeDDeeeeeeeeeeeea
aaaaaaaaaaaaaaaaaaaaSSSSSSSSaaaDDeeeeeeeeeeeeeeeeeeeeeeeeeeeeeeeeDeeeeeeeeeeeeeDeeeeeeeeeeeeeeeeeeeeeeeeeeeeeeeeeDeeeeeeeeeeeeea
aaBaaaaaaaaaaaaaaaaaSSjjjjSSaaaaDeeeeeeeeeeeeeeeeeeeeeeeeeeeeeeeeDeeeeeeeeeeeeeDeeeeeeeeeeeeeeeeeeeeeeeeeeeeeeeeeDeeeeeeeeeeeeea
aaaaaaaaaaaaaaaaaaaaaaaaaaaaaaaaaaaaaaaaaaaaaaaaaaaaaaaaaaaaaaaaaaaaaaaaaaaaaaaaaaaaaaaaaaaaaaaaaaaaaaaaaaaaaaaaaaaaaaaaaaaaaaaa
aaaaaaaaaaaaaaaaaaaaaaaaaaaaaaaaaaaaaaaaaaaaaaaaaaaaaaaaaaaaaaaaaaaaaaaaaaaaaaaaaaaaaaaaaaaaaaaaaaaaaaaaaaaaaaaaaaaaaaaaaaaaaaaa
"}
