"a" = (/turf/open/floor/rogue/dirt,/area/rogue/outdoors/bog)
"b" = (/obj/structure/fluff/traveltile{aportalgoesto = "bogrtout2"; aportalid = "bogrtin2"},/turf/open/floor/rogue/dirt/road,/area/rogue/outdoors/bog)
"c" = (/obj/structure/flora/roguetree,/turf/open/floor/rogue/dirt,/area/rogue/outdoors/bog)
"d" = (/turf/closed/mineral/rogue/bedrock,/area/rogue/indoors/cave)
"e" = (/turf/open/water/swamp/deep,/area/rogue/outdoors/bog)
"f" = (/obj/machinery/light/rogue/firebowl/standing/blue,/turf/open/floor/rogue/dirt/road,/area/rogue/indoors/cave)
"g" = (/turf/closed/mineral/random/rogue/high,/area/rogue/outdoors/bog)
"h" = (/turf/open/water/cleanshallow,/area/rogue/outdoors/bog)
"i" = (/turf/open/water/cleanshallow,/area/rogue/indoors/cave)
"j" = (/turf/closed/wall/mineral/rogue/craftstone,/area/rogue/outdoors/bog)
"k" = (/obj/effect/landmark/mapGenerator/rogue/bog{endTurfX = 128; endTurfY = 128},/turf/closed/mineral/rogue/bedrock,/area/rogue/outdoors/bog)
"l" = (/turf/closed/mineral/random/rogue/high,/area/rogue/indoors/cave)
"o" = (/turf/closed/mineral/rogue/bedrock,/area/rogue/outdoors/bog)
"p" = (/obj/structure/flora/roguetree,/turf/open/water/swamp,/area/rogue/outdoors/bog)
"r" = (/turf/open/floor/rogue/dirt,/area/rogue/indoors/cave)
"v" = (/obj/structure/portal,/turf/closed/mineral/rogue/bedrock,/area/rogue/outdoors/bog)
"w" = (/turf/open/floor/rogue/dirt/road,/area/rogue/indoors/cave)
"y" = (/turf/open/floor/rogue/hexstone,/area/rogue/outdoors/bog)
"B" = (/obj/effect/landmark/events/testportal{aportalloc = "bog"},/turf/open/floor/rogue/dirt/road,/area/rogue/outdoors/bog)
"C" = (/obj/structure/flora/roguetree,/turf/open/floor/rogue/dirt/road,/area/rogue/outdoors/bog)
"D" = (/turf/open/floor/rogue/dirt/road,/area/rogue/outdoors/bog)
"G" = (/turf/open/water/swamp,/area/rogue/outdoors/bog)
"H" = (/obj/structure/flora/roguetree,/turf/open/water/swamp/deep,/area/rogue/outdoors/bog)
"Q" = (/obj/structure/flora/roguetree,/obj/structure/flora/roguetree,/turf/open/floor/rogue/dirt,/area/rogue/outdoors/bog)
"U" = (/obj/machinery/light/rogue/firebowl/standing,/turf/open/floor/rogue/hexstone,/area/rogue/outdoors/bog)
"V" = (/obj/structure/flora/roguetree,/obj/structure/flora/roguetree,/obj/structure/flora/roguetree,/turf/open/floor/rogue/dirt,/area/rogue/outdoors/bog)
"X" = (/obj/effect/landmark/mapGenerator/sunlights{endTurfX = 128; endTurfY = 128},/turf/closed/mineral/rogue/bedrock,/area/rogue/outdoors/bog)
"Y" = (/obj/structure/fluff/traveltile{aportalgoesto = "bogrtout"; aportalid = "bogrtin"},/turf/open/floor/rogue/dirt/road,/area/rogue/outdoors/bog)
"Z" = (/turf/closed/mineral/rogue/salt,/area/rogue/outdoors/bog)

(1,1,1) = {"
oooooooooooooooooooooooooooooooooooooooooooooooooooooooobboooooooooooYYooooooooooooooooooooooooooooooooooooooooooooooooooooooooo
oooooooooooCCGGGGGGGGGGccGGGGGGGGGGGGGGGGGGoooooooooooooDDoooooooooooDDGGGGGccccGGGGGGGGGGGGoooooooooooooooooGGGGooooooooooooooo
oooooooooooCCDaaaGGGGacccaaGGGGGGaaaGGGGGGGGGGGooooooGGGDDGGGGGGGGGGGDDGGGGGcccQGGGGGGGGGGGDDDooooooooooooooGGGDDooooooooooooooo
ooooooCCCCccccaaaaaGaaacaaaaaaaaaaaGGGDDDDDaaaaaaaaaaGGGDDGGGGDDDDDDDDDDDDDDDcccpGGGaaaacGGDDDDaDDaooooooooDGGGDoooooooooooooooo
ooooooaaacccccaaaaaaaaaaaaaaaaaaGGGGGaaccccaaaaaaaaaaaGGDDGGGGaaaaaaaDBaaaaaaaccQaaaaacaGGGaaaaaaDDaaaoooaaaGGaaoooooooooooooooo
ooooeeeGGGccccacccaaGGGGGGGGaacaaGaGaaccccaaaaaaaaaaaaaaDDaaGGaacacccDDaacccaaccccaaaacGGGGaaaGGGGGGGGGGGGGaGGaaoooooooooooooooo
ooooeeeGGGaDaaaaacaGGGGGGGGGGaacaaaGaaccccaGGaaaccccaccaDDaaGGaaccccaDDaaaaaaaaccccaaaaGGGGaaaGGGGGGGGGGGGGGGGaaoooooooooooooooo
ooooeeeeeGaDDaaZaaaGGGGeeGGGGaaccaaGGaccaaaGGaGaccccccaaDDaaaaaaaccacDDaacccaaaccccaaaaaGGaaaGGeeeeeeeeeeeGGGGaaaaaoooooGGGooooo
oooDaGeeeGaDDaaaaaGGGeeeeeeGGGaaaaaGaaaaaGGGGaGaacccccaaDaaaaaaaaaaaaDDacaccaaaacccaaacaGGaaaGeeeeeeeeeeeeeeGGGaaaaaoooooGGGoooo
oooDaGeeeGaaCcaaaaGGGeeeeeeGGGGGaGGGGGGGGGGGGGGaaccaacaaDaaaaaaGaaaaaDDaaaaaGaaacccaaaaaGGGaGGGeeeeeeeeeeeeeeeGGaaaaoooooGGGoooo
oGDDaGeeeGccCccaaaGGGeeeeeeeGGGGGGGGGGGGGGGGGGGaaaaaaaaaDacccaaaaGaaaDDaaccaGaGGGccaaaaaGGGaGGeeeeeeeeeeeeeeeeGGaaaaaaaoGGGooooo
ooDDaGGGeGacCccaccaGGeeeeeeeGGGGGeeeeeeeeeeGGGGGaaaaaaaaDaccaaaGaGaaaDaaaacaGGGGGpppGGaaGGGGGeeeeeeeeeeeeeeeeeGGaaaaaaaGGGoooooo
ooDDaaGaGGacCccaccaGGeeeeeeeGGGGeeeeeeeeeeeGGGGGaacccaaaDaccccaGGGGaaDaaaccaGGGGGpppGGaaaGGGGeeeeeeeeeeeeeeeeeGGDDDDDDDDDGDDDGoo
ooDDaaaaGGaaCcaaaaaGGGGeeeeeGGGeeeeeeeeeeeeeGGGGaacccaaaDaaccaaaGGGGGGGGGGGGGGGGGGppGGaaaGGGeeeeeeeeeeeeeeeeeeGGaaaaaaaaGaGGDGoo
oooDaccaaaaaDaaaaaaaGGGGGGeeeGGeeeeeeeeeeeeeGGaGGGpppGGaaaGaaaGGGGGGGGGGGGGGGGGGGGppGGacaGGGeeeeeeeeeeeeeeeeeeGGaaaaaaaaGGGDDGoo
oooDaaaaaaaaDaaaaaaaaaaGGGeeeGGeeeeeeeeeeeeeGGGGGGpppGGGGGGGGGGGGaGGGGGGGGGGGGGGGGpppGaaaaGGeeeeeeeeeeeeeeeeeeGGGaaaaaaaGGGDDGoo
ooDDDDDDDDDDDDDDDDaaaaaGGGGeeGGeeeeeeeeeeeeeGGGGGGGGGGGGGGGGGGGGGaGGGGGGGppGaGGGGGppGGaaaaGGGeeeeeeeeeeeeeeeeGGGGGaaaaaGGGaDDGoo
oooDaaaaaaaaaaaacCccccaaGGGGGGGeeeeeeeeeeeeeGGGGGGGGGGGGGGGaaaaaaDDDDDaeeeeeeeeeaacccaaaaaaGGGeeeeeeeeeeeeeeeGGaGGGaaaaGGaaDGGoo
ooooaoooooaaaacccCccccaaaaaaaGGeeeeeeeeeeeeeeGGGaaaaaaaaaaaaaaaaaaaaaDaeeeeeeeeeaccccaaaaaaaaGeeeeeeeeeeeeeGGGaaaGGGaaaGaaaDGGoo
ooooooooooooooaccCcccaaaaaaaaGGeeeeeeeeeeeeeeGGGaacccaaaaaaaaaacacaaaDaeeeeeeeeeacccccaaacaaaGGeeeeeeeeeeeeGGGaaGGGGaGaaaaaDGGoo
oooooooaaaooaaaccCcaGGGGGGaaaGGeeeeeeeeeeeeeeGGGaacccaaaccaaccacccaccDaeeeeeeeeeccccaaaaaacaaGGGGGGGGGGGGGGGGaaaGGGGGaaaaaaDGGoo
oooooooaaaaaGGGpcCcaGGaaaGGaaGGGeeeeeeeeeeeeeGGGaaaaaaaaacaccaacccccaDaeeeeeeeeeccccaaaaaaaaaaaaaGGGGGGGGGGGaaaaGGGGaaaaaaaDGGoo
ooooooaaacaaGaaaaDaaaaaaaaaaaaGGeeeeeeeeeeeeGGGGaaaaaaaaccccccaacacacGGeeeeeeeeeaacccccaaGaaaaaaaaaaaaaaaaaaaaaGGGGaaaaaaaGGGGoo
ooooooaaaaaacGGaaDacaaaGGGaaaGGGeeeeeeeeeeeeGGGGaaGGaGGaccccacaaaaaaGGGeeeeeeeeeGGGppppGGGGaaaaaaaacaaaaaaaaaaGGGGGaaaaaaaGGGGoo
ooooooaaZacaGGaaaDaaGGGGGGGGGGGGGGGGGeeGGGGGGGGaGGaaGGaaacacaaaaaaaGGGGeeeeeeeeeGGGGGGGGGGGGaaaaaaaaaaaaaaaaaaGGGGaaaaaaaaGGGGoo
ooooooaaaacaGaaaaDaaGeeeeGGGGeGGGGGGGGGGGGGGGGaaaaaaGaaaaaaaaaaaaaGGGDaeeeeeeeeeGGGGGGGaaaaaaaaaaaaaaacaaaaaaGGGaaaaaaaaaGGGGGoo
ooooooaaaaaaGaaaaDaGGeeeeeeeeeGGGGGGGaaGGGGaaaaaaaGGGaaaaaaaaaacaaaaaDaeeeeeeeeeeeeGGGGaaaaaaaaaaaaaaacaaaaaaaaaaaaaaaaaaGGGGGoo
ooooooaaaaaaGacaaDaGGeeeeeeeeeeGGaaaaaaGGaaaaaaaaaGGGGaaaaaGaaacccaaaDaeeeeeeeeeeeeaaaaaaaaaaaaaaaGaaaaaaaaaaaaaaaaaaaaaaGGDGGoo
ooooooaacaaaaaccaDaaGGGGeeeeGGGGGaaaaaaaaaGGaaaaaaGGGGGaaaaGaaaaaaaaaDaaaaaaaaaeeeeaaaaaaaaaaaaaGGGGGaaaaGGaaaaaaaaaaaaaGGaDGGoo
ooooooaaaaaaaaccaDaaaaaaGGGGGGGGGaaaaaaaaaaGGGaaaaGGGGGaaaaGaaaaaaaaaDaaaaaGGGGaGGaaaaaaaaaaaaaGGGaGGaaaGGGGGGaaaaaaaaGGGaaDGGoo
ooooooaaGGaaaaaaaaaGGGGGGGGGGaaaaaaaaaaaDDDDDGDDDDDDDDDDDDDGDDDDDDDDDDaaaaGGaaaaGGaaaaaaaaaaaGGGaaaaaaaaGGGGGGaaaaaGGGGaaaaDGGoo
ooooooaGGGGGaaaaaGGGGGGGGGaaaaaaGGaaaaaaGGGGGGaaaaaaGaaaaaaGaaaaaaaaaaaaaGGaaaaaaGaaaGGGGGGaaGGaaaaaaaaGGGGGGaaGGGGGaaaaaaaDGGoo
oooooaaGGGGGGGGGGGGGGGGGGGaacaaaaGGaaaaaDaaaaaaaaaaGGGaaaaaaaGaaaaaaaacccGGaaaaaaGGaaaaGGaaaGGGGaaaaaaaGGGGGGaaGaaaaaaaaaaaDGGoo
oooooaGGGeGGGGGGGGGeeeeGGGaacaaaaaGGaaaaDaaaaGGGGGGGGGGaaGGGGaGaaGGGaaaaaGGaaaaaaaGaaaaGaaaaaaaGGGGaaaaaGGGGaaaGaaaaaaaaaaaDGcoo
oooooaGGeeeeeeeeeeeeeeeGppeeHaaaaaaGaaaaDaaaGGGeeeeaeeGGaaGGGaGGGGGGGGGGaaGGGGaaaaaaaaaGaaaaaaaaaaaaaaaaaaaaaaaGaaaaaaaaaaaDGcoo
oooooooeeeeeeeeeeeeeeeeeHHHeHaaaaaaGaaaaDaaaGGeeeeeeeeGGaaGGGaaGGeeGGGGGaaaGGGaaaaaaaaaaaaaaaaaaaaaaaaaaaaaaaaGaaaaaaaaaaaaDccoo
oooooeeeeeeeeeeeeeeeeeeeeHHeHaaaaaGGaaaaDaGGeeeeeeeeeeGGccaGGaaGGeeGGGGGGeeeGGGGGGGGaaaaaaaaaacccaaGaaaaaaaaaaGaaaaaaaaaaaaDccoo
oooooeeeeeeeeeeeeeeeeeeeeHHHHcaaaaGaaaaaDaGGeeeaaaaaeeGGccaGGaaGGeeeeeGGGGeeeeeGGGGGaaaaaaaaccccccGGcaaaaaaaaaGaaaaaaaaaaaacccoo
oGDDaeeeeeeeeeeeeeeeeeeeeHHHHcaaaaaaaaaaDaaGeeaaaaaaeeeGaaaaaaaGGeGGeeeeeeeeeeeeeeeGaaaaaccccccccGGcccaaaaaaaaGGaaaaacaaaaacccoo
oGDDaGGeeeeeeeeeeeeeeHHeeeHHHcaaaaaaaaaaDaaGeeaaaZaaGeeGGaaaaaaaaaGGGGGeeeeeeeeeeeeGGaaaacccccGGGGcccccccccccccGccccccaGGaccccoo
oeeeeeGeeeeeeeeeeeeeeeeeeeHHHccaaaaaZaaaDaaGeeaaaaaaaeeGGGaaaccaaaGGGGGGGeeeeeeeeeeaaaaaaacccccccccccccccccccccGccccccccGcccccoo
oeeeeeeeeeeeeeeeeeeeeeeeeeHHHcaaaaaGGaaaDaGGGeaaaaaaaeGaGGaaaccaaaGGGGGGGeeeeeeGGGGGaaaaaaaacccccccccQQQcccQQQQGccccccccGGccccoo
oGeeeeeeeeeeHHHeeeeeeeeeeeeeHcaaaaaaGaaaDaGGGeeeeeeeeeGGGGGaaaaaacGGGGGGGaaaGGGGGGaaaaaaaaaaaaccccccccQQccccccGGcccccccccGccccoo
oeeeeeGeeeeeeeeeeeeeeeeeeeeaacaaaaaaGGaaDaaGGeeeeeeeeeGGGGGGaaaaaaaGGGGGGaaaaGGGGaaaacccaaaaaaaaaaaaacccccccccGGcccacQacQcaccGoo
oGGeeeGGGGGGGGGGGGGGGGGGGGGGGcaaaaaaaGaaDaaaGGGGGGGGGGaGGaaGaaaDaacaaccpccaaaGGaGGaaccccaccaaaaaaaaaaaaaaDDDGDDDDaaaaaaaaaaccGoo
oGGGGGaaGGGGaGGGGGGGGGppGGGGGcaaaaaaaaaaDaaaaaaaaGGaGaaaaaaGGaaDaaaaaccccaaaaaaGGGaaaaaaaaccaacccaaaaaaaDDaGaaaDDDDDDDDDDDDDDGoo
oGGaaaaaaaGGaaaGGGGGaaccaaaaacaaaaaaaaaaDDDDDDDGDDDDDDDDDDDDGGDDDDDDaaaaaaaaaaaGGGaaGGGaaaacaaccccaGGaaDDaaGaaaaGGaaaaaaaaaaaaoo
oGGaaacaaaGaaaaaaDaaaaccaGaaaaaaaaGaaaaaDaaaaGGaaaaaaaaaaaaaaaaDaaaaaaaaaaaaaaaaaGaaGaGGGGaaaaQQccaGGaaDaaaaaccaGGaaaacccccaccoo
oGGaaaaaaGGaaaaGGDGGaaaaaaGGGGGaGGGGaaaaDaaaGGaaaaGGGaaaaaaaccaDaaaccaaaGGGGGaaaaaaGGaaaaaGaacccaaGGGGaDaaGaaaaaaaaaaccccccaccoo
oGGaaaaaaGaaaaGGGGGaaaaaaaaaGGGGGGGGaGGaDaaaGGGGGGaaaaaaaaaaccaDaaaaGGGaGGGGaaaaccaGaaaaaaaaaaaaaaGGGGaDaaGGaaaaaaaaccccccccccoo
oaGDaaaaaacaaaGGGDGGaaaaaaaaGGeeeeeGGGGGDaaaaaaaaaaaaaaaaaaaaaaDaaaGGGGeeeeGGaaaccaaaaaaaaacaaaaaaGGaaaDaaaGaaaaaaacccccccccccoo
oaGaaacaaaaaaGGaaDaGaaaaccccppeeeeeGGGGGaaaaaaaaaaaaaaeeeeaaaaaDaaGGeeeeeeeGGaaaccaaaaaaacaaaaacccaaaaDDaaaaaaaaacccccooooooccoo
oaaaaaaaaaaGGaaaaDGGaaaaccccppeeeeeeGGGaacccaaaaaaaaeeeeeeaaaaaDaaGGeeeeeeeeeeGGaaaaaaaaacaZaacQQccaaDDaaaaaaaccccccccjvooojccoo
oaacaaaaaaaaGGaaaDaGaaaaccccppeeeeeeGGGGacccaaaaeeeeeeeeeeaaaaaDaaGGeeeeeeeeeeGGaaaaaaaaaaaaaacVccGGaDaaaaaaaccccccaaajUyyUjccoo
oaaaaaaaaccGDGDDDDDGDDDDCCCCCcaaGeeeGGGGaaaaeeeeeeeeeeeeaaaaaaaDaaGGGeeeeeeeeeGGZaaaaaaaaaaccaaaaaaGDDaaaaaaccccccaaaajyyyyjaaoo
ocaaaacaaaaGGGaaaDaGaaccCCccccaaGeeeGGGaaaaaeeeeeeeeaGGaaaaaaaaDaaGGGGGeeeeeeeGGaaaaaaccaaaccaaaaDDGDaaaaaaacccccaaaaajyyyyjaaoo
oaaaaaaaaaaaGGccaDGGaaaaDDaaaaaaGeeeGGaacaaaaGGaaaaaaGaaaaaaaaaDaaGGGGaeeeeeeeGGaaaaaaaaaaaaaaaaaaaaaaaaaaacccccaaaaaaaGaaaaaaoo
oaaaaacaGGaaGGaaaGGGaaaaDDaaaaaaaGGGGGaaaaaGGGaaaaaaGGaaaacaaaaDaaaaGGGGGGGGGGGGaaaDDDDDDDDDDDDDaaaaaaaaaacccccaaaaaGGGaaaaaaaoo
oaaaaaaGGaaaGGaaaaaaaaaaDDaaaaaaaaGGGaaaaaGGGGaaaacaaaaaaccaaaaDaaaaGaaaGGGGGaaaaaaaaaaaaaaaaaaaaaaaaaaaaccccccaaaaGGaaaaaaaaaoo
oaaDaaaGGGaaaaaaaaaaaaaaDDaaaacaaaaaaaaaaGGaaaaaaaaaaaacccaaaaaDaaaaaaaaaaaaaGaGGGGGGGGGaaaaaaGaaGGaGGaGGaaccccaaaaGGaaaaaaaaaoo
oDDDaaaaaaaaaaccaccaaaaaaDaaaaaaaaaaacaaaaaaaaaaaaaaaacccacaaaaDaaaaaaaaaaGGGGaaaGGGaaaaaaaaGGGGGGGGGGaGaaaaaacaaaaGGGaaaaaaaaoo
oDDDaaaaaaaacccccccccaaaaDaaaaaaaaaaaaaaaaacaaaaaacccccccccaaaaDaaaaaaaaaaaGGGaGGaaaaaaaaaaaGaaaaaGGGaaaaaaaaacaGGGGGGGGaaaaaaoo
oaaaaaaaaccccccccccccaaaaDaaaaaaaaaaaaaaaaaaaaaaccacccccccaaaaaDaaaaaGaaaaaaaGGaaaaaaaaaaaaaaaaaaaGGaaaaaaaaaaGGGGGGaaaacccaaaoo
oaaaaaaacccccccccccccccccDaaaaaaaaaaaaaaaaaaaaacacccccccccaaaaaDaaaaGGGaaaaaaGaaaaaaaaaaaGaaaaaaaaaGaaaaGGGGGccaGGGGaaaacccaaaoo
occaaaacccccccccccccccaaaDaaaaaaccccccacacacacccccccccccccaaaaGDaGGGGGaaaaaaaaaaaaaaaaaaGGaaaaaaaaaGaaaaGGGGacccaaaaaaaacccaaaoo
occccccccccccccccccaaaaaaDacccccccccccccccccccccccccccacaaaaaGGGGGGGaaaaaaaaaaaaaaaaaaaaGaaaaaaaaaaaaaGaaaaaaccccaaaaaaaaaaaaaoo
occccccccccccaaaaaaGGGaaaDaaaaaaaaaaaaaaaaacccaaaaaaaaaaaaaaaGGGaaaaaaaaaaaaaaaaaaaaaaaaaaaaaaaaaaGaaaaaaaaaaccccaaaaaaaaaaGaaoo
occaaaaaaaaaaaaaaaaGGGaaaDaaaaaaaaaaaaaaaaaaaaaaaaaaaaaaaaaaGGGDaaaaaaaaaaaaaaaaaccaaaaaaaaaaaaaaaGGaaaaaacaacccccaaaaaaaaaGaaoo
oaaaaaaaaaaaaaaaaaaGGGaaaDaaaaaaaaaaaaaaaGaaaaaaaGGaaaaaaaaGGGaDaaaaaaaaaGGGGGGGpppGGGGGGaaaZaGGaaaaaaaaaacaacacccaaaaaaaaaGaaoo
oaGGaaaaaaaaaaaacaaGGGaaaDDDDDDDDDDDDDDGGGDDDDDDDGGDDDDDDDDGGGGGGGGGGGGGGGGGGGGpppGGpGGGGGGGGGGGaaaaaaaaaacaacaccccaccaaaaaaaaoo
oaaGGaaaaaaaaaaccaaGGGaaaDaaaaaaaaaaaaaGaaaaaaaaaaGaaaaaaaGGGGGGGGGGGGGGGGGGppppppGpGppppppppppGaaaaaaaacccaaacccccccccaaaaaaaoo
oGGGGaaaaaacccccccaaaaaaaDaGaaaaaaaaaaGGaaaaaaaaaaGaaaaaaaGGaGaDaaaaaaaaaGppppppppGpGppGppppGGaaaGGaaaaaappppcacccccccccaaaaaaoo
oGGGGaaaaaaaacccccaaaaaaaDaGaaaaaaaaaGGaaaaeeeeeeeeeeeeeeaaaaaaDaaaaaaaaappppppppppGGGGGGGGpGGaaaaaaaaaaappppcaacaccccccccaacaoo
oGGGaaaaaaaaaaaaaaaaaaaaaDaGaaaaaaaaaGGaaeeeeeeeeeeeeeeeeaaaaaaaaaaaaaacaaccccaccaaaaaaaaaaaaaaaaaaaaaaaappppcaaaaaccaccccaaccoo
oGGGaGaaaaaaaaaaaaaaaaaaaaaaaaaaaaaaaaaaaeeeeGaaaaaaaaaGGaaaaaaaaaaaacaacaccccccaaaaaaaaaaaaaaaaaaaaGGGGGppppcaaaaaaccccccccccoo
oGGDaGaaaaaaaaaaaaaGGGaaGGGaaaaaaaaGaaGGGaaeeeaaaaaaaaaaaaaaaaaaaaaaaaccccccccaaaaaaaaaaaaaaaaaaaaaDDGDCppGGGaaaaaaaaccaacccccoo
oGGDaGaaaaaaaaaaaaaaaaaaaaaaaaaaaaaGGGGaaaeeeeaaaaaaaaaaaaaaaaaaaaccaccccccaaaaaaaaaaaaaaGaGaaaaaaaDDGGCppGGGDDDDDDDDaaaacccccoo
oGGDaGaaaaaaaaaaaGaaaaaaaaaaaGGGaGGGGaaaaaeeaaaaaaaaaaaaaaacacaaaaccccccaaaaaaaGaaaaaaaaaaaaaaaaaccDDGGGGGGGGaaaaaaaDaaaaaaaccoo
oGGDGGaaaaaaaaaaaGaaaaaaaaaaaaaaaaGGGGaaaaaaaaaaccccccccccccccccccccccccaaaaaGGGaaaaGaaaGaaaaacaaaaDDGGGGGGGGaaaaaaaDaaaaaaaaaoo
oGGDGGaaaaaaaaaaaGGaaGaaaaaaaaaaaaaaaGaaaaaaaccccccccccccccccccccccccacaaaaGGGaaaaeeeeeeaaaGaacaaGaGaaaaaaaaaacccaaaDDDDDDDDDGoo
oGGGGGaaaaaaaaaaaaaaaGaaaaaaacccaaaaaaaaaaaaaacacacccccccccaaaaccccaaaaaaaaGaaeeeeeeeeeeaaaGaaaaaGcpaaaaaaaaaaaaaaaGaaaaaaGGDGoo
oGGGGaaaaaaaaaaaaaaaaaaaaaaacccccccaaaaaaaaaaaaccccaaccccaaaaaaaaaaaaaaaaaaaaaeeeeeeeeeeaaGGaaaGGGcCaaaaaaaaGaaaaaaGGaaaaaGGGGoo
oGGDaaaaaaZaaaaaaaaaccaaaaaacccccccccaaaaaaaaaaccaccccaaaaaaaaaaaaaaaaaaaaaaaaeeeeeeeeeeGaGaaaaaGGccpGGGGDGaaaacaaaaaaaccaGGGGoo
oGGDaaaaaaaaaaaaaaacccaaaaaacccaaaaaaaaaaaGaaaaaccaaaaaaaaaaaaaaaaaaaaaaGaaaaGeeeeeeeeeeGGaaaccaGaaaGGGGGDaaGaGaaaaaaaaaaaGGGGoo
oGGDaaaaaaaaaaaaacccccaaaaaaaaaaaaaaaaaaaaaaaaaaaaaaaaaaaaaaaaaacccccaaGGaGeeeeeeeeeeeaaaaaaaccaGaaGGGaaaaaaaGGaaaaaaaaaaaGGGGoo
oGGDaaaaaaaaaaaaaccaaaaaaaaaaaaaaaaZaaaaaGaaaaaaaaaaaaaaaaaaaaaaaaaaaaaeeeeeeeeeeaeeGGGaaaaaaaaaGaaGGGaaaaaacpGaaaaaaaaaaaGGGGoo
oGGDaaccccaaaaaaaccaaaaaaaaaaaaaaaaaaaaaaGaaaaaaaaaaaaaaaaaaaaaaaaaaaaGeeeeeeeaaaaaaaaGGGaaaaaaaaaaaGGaaaaaaccGaaaGGaaaaaGGGGGoo
oGGDaaccccaaaaaaaaaaaaaaaaaaaaaaaaaaaaaaaaaaaaaaaaaaaGGaaaaaaaaaaaaaaaGGGGGGaaaaaaaaaaaaaaGaaaaaaacaGGGGGDaaccaaaaGaaaaaaGGDGGoo
oGGDaaccccaaaaaaaaaaaaaaaaaaaaGaaaGGaaaaaaaaGaaaaaaaaGaaaaaaGGaaaGGaaaGGaGGGaaaaaaaaaaaaaaaaaaaaaacaDDGGGGaaaacaaaaaGaaGGGGGGGoo
oGGGaaaaaaaaaaaaaaaaZaaaaaaaaaGaaaGGGaaaaaaaGaaaaaaaaGaaaaaGGGaaGGGGGaaaaaaaaaaacccaaaaaaaaaaaaaaaaaDGGDGGaaaacccccaGaaGGGGDDGoo
oGGGaaGGaaaaaaaaaaaaaaaaaaaaGGGaaaGaGGGGGGGGGGGaaaaaaaaaaaaGeeeeeeeGaaaaccaaaaaacccaaaaaacccccccaaaaaaaaaaaaaaaaaaaaaGaGaaGGDGoo
oGGGaaaGGaGGaGaaaaaaaaaaaaaaaaGGaaGaaaGGaaaGaaaaaaaaaaaaaaaGeeeeeeeGaaaaccaaaaaaaaaaaaaaaaaaaaaaaaaaaaaaaaaaaaaaaaaaaGGaaaGDDGoo
oGGGaaaaGGaGGGaaaaGGGGpaaaaaaaaaaaGaaaGeeeeGaaaaaaaaaaaaaaGGeeeeeeeGGaaaaaaGaaaaaaaaaaaaaaaaaaaaaaaaaaaaaaaaaaaaaaaaaaGaaGGDDGoo
oGGGaaaaaaaaaaaaaaGGGGaaaaaaaaaaaGGaaaGeeeeaaaaaaaaaaaaaaaGeeeeeeeeGGGaaaaaGaaaaogggoaaooaaaaaaaaaaaaaaccccccaaaaaaaaaaaaGaDDGoo
oGGDaaaaaaaaaaaaaaGGGGaaaaaaGGGaGGaaaaGGeeeaaaaaaccaaaaaaaGeeeeeeeeGGaaaaaaGaaaooggggggggoooaaaaaaaaaaaccccccaaaaaaaaaaaaGGDDGoo
oGGGaaaGGaaaaaaaaGGGaaaaaaaaGGGaaaaaaaGGeeeGaaaaaccaaaaaaGGeeeeeeeeeGaaacaaGaaaooooggggggggggggooaaaaaaccccccaaaaaaaaaaaaGGDDGoo
oGDDaaaaGGGaaaaaaaGGaaaaaaGGGGGGaaacaaGGGeeaaaaacccaaaaaaGGeeeeeeeeeGaaacaaGGaaaaaoooogggggggggooooaaaaaaaaaaacccccaahhaaGGDDGoo
oGDDaaaaaaaaaaaaccaaaaaaaappGGGGGaaaaaaGGeeGaacccccaaaaaGGGeeeeeeeeeGaGacaaaGaacccaaoogggggggggooooaaaaDDaaaaacccccaahhaaGGGGGoo
oGDDaaaaaccaaaaaccaaaaaaacccGeeeeaaaaaaGGeeGaacccccaaaaaaGGeeeeeeeeeGGGaaaaaGaacccaaaogggggggggoooooooaDDDDDDDaaaaaaahhaaaaGGGoo
oGDDaaaaaccaaaaaccaaaaaaacccGeeeeGGaaaaGGGGGaaccccccaaaaaaaGGGGGGGGaGGGaaaaaGaaaaaaaaogggggggggoooooooooDDDDDDaaaaaahhhaaaaDDGoo
oGDDaaaaaaGaaaaaaaaaaZZaaaaaGGeeeeeGaaaGGGGGaaccccccaaaaaaaaaaaaaaaGGGGGGGaGGaaaaDDDDDgggggggggooooooowwwDDDDDDaaaaahhhaaaaDDGoo
oGDDaaaaaaaGGaaaaaaaaaaaaaaaGGeeeeeGaaaaGGGGaaccccccaaaaaaacacccaaaaGGaaGGGaaaaaaDDDDDoogggggggodddwwwwwwoooDDDaaoaahhhaaaaDDGoo
oGDDGGGGaaaaaGaaaaaaaaaaaaaaGGGaaaaaaGaaaaaaaaacccccaaaaaaaaacccaaaaGaaaGaaaaaaaowwwwwdogggggggoddwwwwwddooooooooooohhhooooooooo
oGDDaGGGGaaaaaGGGaaaaaaaaaaaGGGaaaaaaGaaaaaaaaccccccaaaaaaaaaaGeeGGGGGaaGGaaacaaowwwwdddlllllllodwwwwddooooooooooooohhhooooooooo
oGDDaaaaGGGGGaaaGGaaccaaaaaaaaaaaaaaaGGGaaaaaaccccccaaaaaaaGGGaeeGGaaaaaaaaaacaadwwwwllllllllllllwwwlllllllllllllddwiiwddddddddo
oGDGGaaaaGaaaaGGGGaaccaaaaaaaaaaaaaGGGaGaaaaaaccccccaaaaaaGGaGaeeeGaaaaaaGaaaaaodwwwwllllllllllllwwwlllllllllllllddwiiiiwllllldo
oGGGaaGGaGaaaaaaaaaaaaaaaaaaaaaaaaaaGGaaaaaaaaccccccaaaaaGGGGeeeeeGGaacaaGaaaaagldwwwllllllllllllwwdlllllllllllllddwiiiiwllllldo
oGGGaaaGGGaaaaaaaaaaaaaaGaaaaaaaaaaaaaaaaaGaaaacccccaaaaaGaGGeeeeeGGaacaaaGaaaagldwwwllllllllllllwwwlllllllllllllddwwiiiwllllldo
oGGGGaaaaaaaaaaaaaaaaGGGGaaaaaaaaaaGaaaaaaGaaaacccccaaaaaGaGGeeeeGaaaacaaaGGaaaglddwwwlllllllllddwwwlllllllllllllddwiiiidllllldo
oGGGGaaaaaaaaaaaaaGGGGGGaaaacccccaaGaaaaaaGGGaacccccaaaGeeeeeeeeeGaaaaaaaaaGaaagldwwwwddddddddddddiwddddddddddddlldlliillllllldo
oGGGGaaaaaaaaaaaaaaaaaGGGGaaaaaaaaaGGaaaaaaGGaacccccaaaGeeeeeeGGGGaaaaGaaaaaaaoglwrwrwwwwwwdddddddiwdwwwfdddddddlldlliillllllldo
oGDGGaaaaaaaaaaaaaaaaaaaaaaaaaaaaaaaGaaaaaaaaaaccaaaaaaGeeeeeeGaGaaaaGGaaaaaaaowwwrwrrwwrrrrrwwwdwiwwwwwwwwwdddddlllliillllllldo
oGDGGaaacaaaaaaaaaacccaaaaaaaaaaaaaaGaacaaaaaaaaaaaaaaaGGGeeeeGGaaaaGGaaaaaaaaodwwrrrrrrrrrrrrwwwwiwwddwwwwiiiiddllllllllllldddo
oGDDGaaaaaaaaaaaaaaaaaaaaaaaaaaaaaaaaaacaaaaaaaaaaaaaaaGGGGGGGaaaaaGGaaaaaaaaoodwwwwrrrrrrrrrrwwwdiwwdddwwwiiiiddllllllllllldddo
oGDGGaaGGaaaaaaaaaaaaaaaaaGaaaaccccaaaaaaaaaaaaacaaaaGGaaaaGGaaaaaGGaaaaaaaaDooddddwrrrrrrrrrriiiiiiwddwwwwwdddddllllllllllldddo
oGDGGaaGGaaaaaGaaaaaaaGGaaGaaaaccccaaaaaaaaGGaaacaaaaaGGGGGaaaaaGGaaccccccDDDodwwdddrrrrrrrrrriiiiiiwddfwwddddddddlllllllddddddo
oGDDGGGGaaaaaaGaaaaaaGGGaaGaaaaccccaaaaaaGGGaaaaaaaaaaaaaaaaaaGGGaaaccccccDDwwwwwwddwrwwwwwrrriiiiiiwwdwwwwdddddldlllllllddddddo
oGDDGGGGaaaaaaaaaaaaaaaaaaGaaaaaaaaaaaGGaGaGaaaaaGGaaaaaaaaaaaaaaaaaccccccaowwwwwwwdllllldwrrriiiiiirwwdwwwwiiddlllllllllddddddo
oGDDGGGaaaaaaaaaaaacccccaaaGGaaaaaaaaaaGGGaGGaacaaGGaaaaaaaaaaaaaaaaaaaaaooodwwwwwwdlllllwwrrriiiiiirwwdwwwiiiddddlllldddddddddo
oGDGGGGaaaaaaaaaaaacccccaaaaaGaaaaaaGGGGGGGaGaacaaGGGGaaGaaaaaaaaaaaaaaaaoddwwwwdwwwlllllwwrrrrwddirwwwdwwiiiidddddddldddddddddo
oGDGGGGGaaaaaaaaaaaaaaaaaaaaaGaaaaaaGGaaGGGGGaaaaaaGGGGaGGaaaaaaaaaaaaaooodwwwllllwwwwwwwwwrrrrwwiiwwwddwwdddddddddddddddddddddo
oGGGGGGGGaaaaaaaaaaaaaaaaGaGGGGGGGGGGaGGGGGGGaaaaaaaaGGGGGGaaaaaaaaaaaaoddrwwwllllwwwwrrrrrrrrrwdriwwwwwwwdddddddddddddddddddddo
oGGGGDGGGGDDDDDDDDDGGDDDGGGGGGGGDDDDDDDDDGDDDDDCCCDDDDDDGGGGDDDDDDDDDDoodwwwwwlllldddwwwwwwrwwwwddiwwwwwwwiidddddddddddddddddddo
oGGGDDDGGGGGGGGDGGGGGDGGGGGGGDDDDDDDDCDDDDDDDDDDDDDDDDDDDDDGGGDDDDDDDDodwddwwwlllllllldwwddwwwwldwiwddwwfwwwdddddddddddddddddddo
oGGGGGGGGGGGGGGGGGGGGGGGGGGGGGGGGGGGGGGGGGGGGGGGGGGGGGGGGGGGGGGGGGGGGooddllllllllllllllllllllllliiiddddddddddddddddddddddddddddo
oooooooooooooooooooooooooooooooooooooooooooooooooooooooooooooooooooooooddlllllddlllllllllllllllddddddddddddddddddddddddddddddddo
oooooooooooooooooooooooooooooooooooooooooooooooooooooooooooooooooooooooooooooooooooooooooooooooooooooooooooooooooooooooooooooooo
kXoooooooooooooooooooooooooooooooooooooooooooooooooooooooooooooooooooooooooooooooooooooooooooooooooooooooooooooooooooooooooooooo
"}
