"a" = (/turf/open/floor/rogue/naturalstone,/area/rogue/outdoors/caves)
"w" = (/turf/open/floor/rogue/naturalstone,/area/rogue/outdoors/spidercave)
"C" = (/turf/closed/wall/mineral/rogue/decostone/center,/area/rogue/outdoors/caves)
"D" = (/turf/closed/mineral/rogue/bedrock,/area/rogue/outdoors/spidercave)

(1,1,1) = {"
CCCCCCCCCCCCCCCCCCCCCCCCCCCCCCCCCCCCCC
CaaaaaaaaaaaaaaaaaaaaaaaaaaaaaaaaaaaaC
CaaaaaaaaaaaaaaaaaaaaaaaaaaaaaaaaaaaaC
CaaaaaaaaaaaaaaaaaaaaaaaaaaaaaaaaaaaaC
CaaaaaaaaaaaaaaaaaaaaaaaaaaaaaaaaaaaaC
CaaaaaaaaaaaaaaaaaaaaaaaaaaaaaaaaaaaaC
CaaaaaaaaaaaaaaaaaaaaaaaaaaaaaaaaaaaaC
CaaaaaaaaaaaaaaaaaaaaaaaaaaaaaaaaaaaaC
CaaaaaaaaaaaaaaaaaaaaaaaaaaaaaaaaaaaaC
CaaaaaaaaaaaaaaaaaaaaaaaaaaaaaaaaaaaaC
CaaaaaaaaaaaaaaaaaaaaaaaaaaaaaaaaaaaaC
CaaaaaaaaaaaaaaaaaaaaaaaaaaaaaaaaaaaaC
CaaaaaaaaaaaaaaaaaaaaaaaaaaaaaaaaaaaaC
CaaaaaaaaaaaaaaaaaaaaaaaaaaaaaaaaaaaaC
CaaaaaaaaaaaaaaaaaaaaaaaaaaaaaaaaaaaaC
CaaaaaaaaaaaaaaaaaaaaaaaaaaaaaaaaaaaaC
CaaaaaaaaaaaaaaaaaaaaaaaaaaaaaaaaaaaaC
CaaaaaaaaaaaaaaaaaaaaaaaaaaaaaaaaaaaaC
CaaaaaaaaaaaaaaaaaaaaaaaaaaaaaaaaaaaaC
CaaaaaaaaaaaaaaaaaaaaaaaaaaaaaaaaaaaaC
CaaaaaaaaaaaaaaaaaaaaaaaaaaaaaaaaaaaaC
CaaaaaaaaaaaaaaaaaaaaaaaaaaaaaaaaaaaaC
CaaaaaaaaaaaaaaaaaaaaaaaaaaaaaaaaaaaaC
CaaaaaaaaaaaaaaaaaaaaaaaaaaaaaaaaaaaaC
CaaaaaaaaaaaaaaaaaaaaaaaaaaaaaaaaaaaaC
CaaaaaaaaaaaaaaaaaaaaaaaaaaaaaaaaaaaaC
CaaaaaaaaaaaaaaaaaaaaaaaaaaaaaaaaaaaaC
CaaaaaaaaaaaaaaaaaaaaaaaaaaaaaaaaaaaaC
CaaaaaaaaaaaaaaaaaaaaaaaaaaaaaaaaaaaaC
CaaaaaaaaaaaaaaaaaaaaaaaaaaaaaaaaaaaaC
CaaaaaaaaaaaaaaaaaaaaaaaaaaaaaaaaaaaaC
CaaaaaaaaaaaaaaaaaaaaaaaaaaaaaaaaaaaaC
CaaaaaaaaaaaaaaaaaaaaaaaaaaaaaaaaaaaaC
CaaaaaaaaaaaaaaaaaaaaaaaaaaaaaaaaaaaaC
CaaaaaaaaaaaaaaaaaaaaaaaaaaaaaaaaaaaaC
CaaaaaaaaaaaaaaaaaaaaaaaaaaaaaaaaaaaaC
CaaaaaaaaaaaaaaaaaaaaaaaaaaaaaaaaaaaaC
CaaaaaaaaaaaaaaaaaaaaaaaaaaaaaaaaaaaaC
CaaaaaaaaaaaaaaaaaaaaaaaaaaaaaaaaaaaaC
CaaaaaaaaaaaaaaaaaaaaaaaaaaaaaaaaaaaaC
CaaaaaaaaaaaaaaaaaaaaaaaaaaaaaaaaaaaaC
CaaaaaaaaaaaaaaaaaaaaaaaaaaaaaaaaaaaaC
CaaaaaaaaaaaaaaaaaaaaaaaaaaaaaaaaaaaaC
CaaaaaaaaaaaaaaaaaaaaaaaaaaaaaaaaaaaaC
CaaaaaaaaaaaaaaaaaaaaaaaaaaaaaaaaaaaaC
CaaaaaaaaaaaaaaaaaaaaaaaaaaaaaaaaaaaaC
CaaaaaaaaaaaaaaaaaaaaaaaaaaaaaaaaaaaaC
CaaaaaaaaaaaaaaaaaaaaaaaaaaaaaaaaaaaaC
CaaaaaaaaaaaaaaaaaaaaaaaaaaaaaCCCCCCaC
CCCCCCCCCCCCCCCCCCCCCCCCCCCCCCCDwwDCCC
"}
