//MAP CONVERTED BY dmm2tgm.py THIS HEADER COMMENT PREVENTS RECONVERSION, DO NOT REMOVE
"a" = (
/turf/open/floor/rogue/naturalstone,
/area/rogue/outdoors/caves)
"c" = (
/obj/machinery/light/roguestreet/midlamp,
/turf/closed/wall/mineral/rogue/stonebrick,
/area/rogue/outdoors/caves)
"k" = (
/turf/open/floor/rogue/sandstone,
/area/rogue/outdoors/caves)
"v" = (
/obj/machinery/light/roguestreet,
/turf/open/floor/rogue/greenstone,
/area/rogue/outdoors/caves)
"w" = (
/turf/open/floor/rogue/naturalstone,
/area/rogue/outdoors/spidercave)
"C" = (
/turf/closed/wall/mineral/rogue/decostone/center,
/area/rogue/outdoors/caves)
"D" = (
/turf/closed/mineral/rogue/bedrock,
/area/rogue/outdoors/spidercave)
"E" = (
/obj/effect/spawner/roguemap/xylixlabyrinth_frowny,
/turf/open/transparent/openspace,
/area/rogue/outdoors/caves)
"G" = (
/turf/closed/wall/mineral/rogue/stonebrick,
/area/rogue/outdoors/caves)
"H" = (
/obj/machinery/light/roguestreet{
	dir = 1
	},
/turf/open/floor/rogue/greenstone,
/area/rogue/outdoors/caves)
"K" = (
/turf/open/floor/rogue/concrete,
/area/rogue/outdoors/caves)
"R" = (
/turf/open/floor/rogue/greenstone,
/area/rogue/outdoors/caves)
"S" = (
/obj/effect/spawner/roguemap/xylixlabyrinth,
/turf/open/floor/rogue/sandstone,
/area/rogue/outdoors/caves)
"W" = (
/obj/structure/fluff/statue/xylix,
/turf/open/floor/rogue/greenstone,
/area/rogue/outdoors/caves)

(1,1,1) = {"
G
G
G
G
G
G
G
G
G
G
G
G
G
G
G
G
G
G
G
G
G
G
G
G
G
G
G
G
G
G
G
G
G
G
G
G
G
G
G
G
G
G
G
G
G
G
G
G
G
G
"}
(2,1,1) = {"
G
k
k
k
k
k
k
k
k
k
k
k
k
k
k
k
G
k
k
k
k
k
k
G
k
k
k
k
k
k
G
k
k
G
k
k
k
k
k
k
G
G
G
G
k
k
k
k
k
G
"}
(3,1,1) = {"
G
k
k
k
k
k
k
k
k
k
k
k
k
k
k
k
G
k
k
k
k
k
k
G
k
k
k
k
k
k
G
k
k
G
k
k
k
k
k
k
G
G
G
G
k
k
k
k
k
G
"}
(4,1,1) = {"
G
k
k
G
G
G
G
S
k
c
G
G
G
G
k
k
G
k
k
G
G
G
G
G
G
G
G
G
k
k
G
k
k
k
k
k
G
G
k
k
k
k
k
k
k
k
c
k
k
G
"}
(5,1,1) = {"
G
k
k
k
k
k
G
k
k
k
k
k
k
G
k
k
G
k
k
k
S
k
k
k
k
k
k
k
k
k
G
k
k
k
k
k
G
G
k
k
k
k
k
k
k
k
G
k
k
G
"}
(6,1,1) = {"
G
k
k
k
k
k
G
k
k
k
k
k
k
G
k
k
G
k
k
k
k
k
k
k
k
k
k
k
k
k
G
k
k
G
G
G
G
G
G
G
G
G
G
G
G
G
G
k
k
G
"}
(7,1,1) = {"
G
G
G
G
G
G
G
G
G
G
G
k
k
G
k
k
c
k
k
G
k
k
c
G
G
G
G
G
k
k
c
k
k
G
k
k
k
k
k
k
k
k
k
k
k
k
k
k
k
G
"}
(8,1,1) = {"
G
G
G
G
G
G
G
G
G
G
G
k
k
G
k
k
k
k
k
G
k
k
k
k
k
G
G
G
k
k
k
k
k
G
k
k
k
k
k
k
k
k
k
k
k
k
k
k
k
G
"}
(9,1,1) = {"
G
G
G
G
G
G
G
G
G
G
G
k
k
G
k
k
k
k
k
G
k
k
k
k
k
G
G
G
k
k
k
k
k
G
G
G
G
G
c
k
S
k
G
G
G
G
G
G
G
G
"}
(10,1,1) = {"
G
R
v
R
G
G
G
R
v
R
G
k
k
G
G
G
G
G
G
G
G
G
G
k
k
G
G
G
k
k
k
k
k
G
k
k
k
k
k
k
k
k
k
k
k
k
k
k
k
G
"}
(11,1,1) = {"
G
k
K
k
E
k
E
k
E
k
G
k
k
k
k
k
G
k
k
k
k
k
G
k
k
G
G
G
G
G
G
k
k
G
k
k
k
k
k
k
k
k
k
k
k
k
k
k
k
G
"}
(12,1,1) = {"
G
K
k
K
k
E
k
E
k
E
G
k
k
k
k
k
G
k
k
k
k
k
G
G
G
G
k
k
k
k
k
S
k
G
k
k
G
G
G
G
G
G
G
G
G
G
G
k
k
G
"}
(13,1,1) = {"
G
k
K
k
E
k
E
k
E
k
G
G
G
c
k
k
G
k
k
c
k
k
k
k
k
G
k
k
k
k
k
k
k
k
k
k
k
k
k
k
G
k
k
k
k
k
G
k
k
G
"}
(14,1,1) = {"
G
K
k
K
k
E
k
E
k
E
k
k
G
G
k
k
G
k
k
G
k
k
k
k
k
G
k
k
G
G
G
k
k
k
k
k
k
k
k
k
G
k
k
k
k
k
G
k
k
G
"}
(15,1,1) = {"
G
k
K
k
R
R
R
k
E
k
k
k
k
k
k
k
G
k
k
G
G
G
G
k
k
G
k
k
G
G
G
G
G
G
G
G
G
G
G
G
G
G
G
G
k
k
c
k
k
G
"}
(16,1,1) = {"
G
K
k
K
W
R
R
E
k
E
k
k
k
k
k
k
G
k
k
G
k
k
G
k
k
G
k
k
G
G
G
G
k
k
k
k
k
k
k
k
k
k
k
G
k
k
k
k
k
G
"}
(17,1,1) = {"
G
k
K
k
R
R
R
k
E
k
k
k
G
G
G
G
G
k
k
G
k
k
G
k
k
G
k
k
k
k
k
G
k
k
k
k
k
k
k
k
k
k
k
G
k
k
k
k
k
G
"}
(18,1,1) = {"
G
K
k
K
k
E
k
E
k
E
G
G
G
G
G
G
G
k
k
G
k
k
G
k
k
G
k
k
k
k
k
c
k
k
G
G
G
G
G
G
G
k
k
G
G
G
G
G
G
G
"}
(19,1,1) = {"
G
k
K
k
E
k
E
k
E
k
G
G
G
G
k
k
k
k
k
G
k
k
k
S
k
k
k
k
G
k
k
k
k
k
k
k
G
k
k
k
a
k
k
k
k
k
G
k
k
G
"}
(20,1,1) = {"
G
K
k
K
k
E
k
E
k
E
G
G
G
G
k
k
k
k
k
G
k
k
k
k
k
k
k
k
G
k
k
k
k
k
k
k
G
k
k
k
a
k
k
k
k
k
G
k
k
G
"}
(21,1,1) = {"
G
k
K
k
E
k
E
k
E
k
G
G
G
G
k
k
c
G
G
G
G
G
G
G
G
G
G
G
G
G
G
G
G
G
k
k
G
k
k
c
G
k
k
G
k
k
c
k
k
G
"}
(22,1,1) = {"
G
R
H
R
G
G
G
R
H
R
G
G
G
G
k
k
k
k
k
k
G
k
k
k
k
k
k
k
k
k
G
k
k
G
k
k
G
k
k
k
k
k
k
G
k
k
k
k
k
G
"}
(23,1,1) = {"
G
G
G
G
G
G
G
G
G
G
G
G
G
G
k
k
k
k
k
k
G
k
k
k
k
k
k
k
k
k
G
k
k
G
k
k
G
k
k
k
k
k
k
G
k
k
k
k
k
G
"}
(24,1,1) = {"
G
k
k
k
k
k
k
k
k
k
k
k
k
G
k
k
G
G
k
k
G
G
G
G
G
G
G
G
k
k
G
k
k
G
G
G
G
G
G
G
G
G
G
G
G
G
G
G
G
G
"}
(25,1,1) = {"
C
k
k
k
k
k
k
k
k
k
k
k
k
G
k
k
G
G
k
k
k
k
k
k
k
k
k
k
S
k
G
k
k
k
k
k
G
k
k
k
k
k
G
k
k
k
k
k
G
G
"}
(26,1,1) = {"
C
k
k
k
k
k
k
k
k
k
k
k
k
G
k
k
G
G
k
k
k
k
k
k
k
k
k
k
k
k
G
k
k
k
k
k
G
k
k
k
k
k
G
k
k
k
k
k
G
G
"}
(27,1,1) = {"
C
k
k
k
k
k
k
k
k
k
k
k
k
G
k
k
G
G
k
k
G
G
G
G
G
G
G
c
k
k
G
G
G
c
k
k
G
k
k
c
k
k
G
k
k
c
k
k
G
G
"}
(28,1,1) = {"
C
k
k
k
k
k
k
k
k
k
k
k
k
G
k
k
k
G
k
k
G
k
k
k
k
k
k
k
k
k
k
k
k
k
k
k
G
k
k
G
k
k
G
k
k
G
k
k
G
G
"}
(29,1,1) = {"
C
k
k
k
k
k
k
k
k
k
k
k
k
G
k
k
k
G
k
k
G
k
k
k
k
k
k
k
k
k
k
k
k
k
k
k
G
k
k
G
k
k
G
k
k
G
k
k
G
G
"}
(30,1,1) = {"
C
k
k
k
k
k
k
k
k
k
k
k
k
G
G
G
G
G
k
k
G
k
k
c
G
G
G
G
G
G
G
G
G
G
G
G
a
G
G
G
k
k
G
G
G
G
k
k
G
G
"}
(31,1,1) = {"
C
k
k
k
k
k
k
k
k
k
k
k
k
k
k
G
k
k
k
k
G
k
k
k
k
k
k
k
k
k
G
k
k
k
k
k
k
k
k
k
k
S
k
k
k
G
k
k
G
G
"}
(32,1,1) = {"
C
k
k
k
k
k
k
k
k
k
k
k
k
k
k
G
k
k
k
k
G
k
k
k
k
k
k
k
k
k
G
k
k
k
k
k
k
k
k
k
k
k
k
k
k
G
k
k
c
D
"}
(33,1,1) = {"
C
k
k
k
k
k
k
k
k
k
k
k
k
k
k
G
k
k
c
G
G
G
G
G
G
G
G
G
k
k
G
k
k
G
k
k
c
G
G
G
G
G
G
k
k
G
k
k
k
w
"}
(34,1,1) = {"
C
k
k
k
k
k
k
k
k
k
k
k
k
k
k
G
k
k
k
k
k
k
k
k
k
k
k
G
k
k
c
k
k
G
k
k
k
k
k
k
k
k
G
k
k
G
k
k
k
w
"}
(35,1,1) = {"
C
k
k
k
k
k
k
k
k
k
k
k
k
k
k
G
k
k
k
k
k
k
k
k
k
k
k
G
k
k
k
k
k
G
k
k
k
k
k
k
k
k
G
k
k
c
k
k
G
D
"}
(36,1,1) = {"
C
k
k
k
k
k
k
k
k
k
k
k
k
k
k
G
G
G
G
G
G
G
G
G
G
G
G
G
k
k
k
k
k
G
G
G
G
G
G
G
k
k
G
k
k
k
k
k
G
G
"}
(37,1,1) = {"
C
k
k
k
k
k
k
k
k
k
k
k
k
k
k
G
G
G
G
G
G
G
G
G
G
G
G
G
G
G
G
G
G
G
G
G
G
G
G
G
k
k
G
k
k
k
k
k
G
C
"}
(38,1,1) = {"
C
C
C
C
C
C
C
C
C
C
C
C
C
C
C
C
C
C
C
C
C
C
C
C
C
C
C
C
C
C
C
C
C
C
C
C
C
C
C
G
G
G
G
G
G
G
G
G
G
C
"}
