//MAP CONVERTED BY dmm2tgm.py THIS HEADER COMMENT PREVENTS RECONVERSION, DO NOT REMOVE
"a" = (
/turf/open/floor/rogue/dirt,
/area/rogue/outdoors/exposed/decap)
"g" = (
/turf/open/floor/rogue/naturalstone,
/area/rogue/outdoors/exposed/decap)
"h" = (
/obj/structure/fluff/railing/fence{
	dir = 4
	},
/turf/open/floor/rogue/dirt,
/area/rogue/outdoors/exposed/decap)
"m" = (
/turf/open/floor/rogue/naturalstone,
/area/rogue/under/cavelava)
"p" = (
/obj/structure/bed/rogue/sleepingbag,
/turf/open/floor/rogue/naturalstone,
/area/rogue/outdoors/exposed/decap)
"q" = (
/obj/structure/ladder/earth,
/turf/open/transparent/openspace,
/area/rogue/outdoors/exposed/decap)
"s" = (
/obj/structure/flora/newtree,
/turf/open/floor/rogue/grass,
/area/rogue/outdoors/exposed/decap)
"t" = (
/obj/machinery/light/rogue/campfire/densefire,
/turf/open/floor/rogue/naturalstone,
/area/rogue/outdoors/exposed/decap)
"u" = (
/obj/item/storage/roguebag,
/turf/open/floor/rogue/naturalstone,
/area/rogue/outdoors/exposed/decap)
"x" = (
/obj/structure/closet/crate/chest/crafted,
/obj/item/reagent_containers/food/snacks/rogue/meat/salami/slice,
/obj/item/reagent_containers/food/snacks/rogue/cheddarslice/aged,
/obj/item/reagent_containers/food/snacks/fat/salo/slice,
/obj/item/reagent_containers/food/snacks/rogue/saltfish,
/turf/open/floor/rogue/naturalstone,
/area/rogue/outdoors/exposed/decap)
"y" = (
/obj/structure/ladder/earth,
/turf/open/floor/rogue/naturalstone,
/area/rogue/under/cavelava)
"z" = (
/turf/open/floor/rogue/grass,
/area/rogue/outdoors/exposed/decap)
"B" = (
/turf/closed/mineral/random/rogue/med,
/area/rogue/outdoors/exposed/decap)
"C" = (
/obj/structure/fluff/railing/fence,
/turf/open/floor/rogue/dirt,
/area/rogue/outdoors/exposed/decap)
"E" = (
/obj/structure/ladder/earth,
/turf/open/floor/rogue/naturalstone,
/area/rogue/outdoors/exposed/decap)
"F" = (
/turf/open/transparent/openspace,
/area/rogue/outdoors/exposed/decap)
"G" = (
/obj/item/grown/log/tree/small,
/obj/structure/closet/crate/chest/crafted,
/obj/item/reagent_containers/powder/salt,
/obj/item/rogueore/coal,
/turf/open/floor/rogue/naturalstone,
/area/rogue/outdoors/exposed/decap)
"H" = (
/obj/structure/flora/newtree,
/turf/open/floor/rogue/dirt,
/area/rogue/outdoors/exposed/decap)
"M" = (
/turf/closed/mineral/random/rogue/med,
/area/rogue/under/cavelava)
"N" = (
/obj/structure/fluff/railing/fence{
	dir = 4
	},
/turf/open/floor/rogue/grass,
/area/rogue/outdoors/exposed/decap)
"P" = (
/obj/item/rogueweapon/pick,
/turf/open/floor/rogue/naturalstone,
/area/rogue/outdoors/exposed/decap)
"R" = (
/turf/closed/mineral/random/rogue/high,
/area/rogue/under/cavelava)
"S" = (
/obj/item/rope,
/turf/open/floor/rogue/naturalstone,
/area/rogue/outdoors/exposed/decap)
"T" = (
/obj/structure/fluff/railing/fence{
	dir = 4
	},
/turf/open/floor/rogue/naturalstone,
/area/rogue/outdoors/exposed/decap)
"U" = (
/obj/item/sleepingbag,
/turf/open/floor/rogue/naturalstone,
/area/rogue/outdoors/exposed/decap)
"W" = (
/obj/structure/fluff/railing/fence,
/obj/structure/fluff/railing/fence{
	dir = 4
	},
/turf/open/floor/rogue/dirt,
/area/rogue/outdoors/exposed/decap)
"Y" = (
/obj/item/reagent_containers/glass/cup,
/turf/open/floor/rogue/naturalstone,
/area/rogue/outdoors/exposed/decap)
"Z" = (
/obj/item/reagent_containers/glass/bottle/waterskin,
/turf/open/floor/rogue/naturalstone,
/area/rogue/outdoors/exposed/decap)

(1,1,1) = {"
M
M
M
M
M
M
M
M
M
M
M
M
M
M
M
M
M
M
M
M
M
M
M
M
M
M
M
M
M
M
M
M
M
M
M
"}
(2,1,1) = {"
M
M
M
M
M
M
M
M
M
M
M
R
M
M
M
M
M
M
M
M
M
M
M
M
M
M
M
M
M
M
M
M
M
M
M
"}
(3,1,1) = {"
M
M
M
R
M
R
M
m
M
m
m
m
R
m
M
M
M
M
M
M
M
M
M
M
M
M
M
R
R
R
R
M
M
M
M
"}
(4,1,1) = {"
M
M
M
M
M
M
M
m
m
m
m
m
m
m
M
M
R
R
M
M
M
R
R
M
M
M
R
R
M
M
R
M
M
M
M
"}
(5,1,1) = {"
M
M
M
M
M
M
M
M
m
m
y
m
m
M
M
R
R
M
M
M
M
R
R
M
M
R
M
M
M
M
M
M
M
M
M
"}
(6,1,1) = {"
M
M
M
M
R
M
M
M
M
m
m
m
m
M
M
M
M
M
M
M
M
R
M
M
R
R
M
M
M
M
M
M
M
M
M
"}
(7,1,1) = {"
M
M
M
M
R
M
M
M
M
m
m
m
m
m
M
M
M
M
M
M
M
M
M
M
M
M
M
M
M
M
M
M
M
M
M
"}
(8,1,1) = {"
M
M
M
M
R
M
M
M
M
M
m
M
m
m
M
M
M
M
M
M
M
M
M
R
M
M
M
M
M
M
M
M
M
M
M
"}
(9,1,1) = {"
M
M
R
M
R
M
M
M
M
M
m
M
R
M
M
M
M
M
M
M
M
M
R
M
M
R
R
R
M
M
M
M
M
M
M
"}
(10,1,1) = {"
M
M
M
M
M
M
M
M
R
M
m
M
M
R
R
R
M
M
M
M
M
M
R
M
M
M
M
M
M
M
R
M
M
M
M
"}
(11,1,1) = {"
M
M
M
M
M
M
M
M
M
M
M
M
M
M
M
M
M
M
M
M
M
R
M
M
M
M
M
M
M
M
M
M
M
M
M
"}
(12,1,1) = {"
M
M
M
M
M
M
M
M
M
M
M
M
M
M
M
M
R
M
M
M
R
M
M
M
M
M
M
M
M
M
M
M
M
M
M
"}
(13,1,1) = {"
M
M
M
M
R
M
R
M
M
R
M
M
M
M
M
M
R
M
M
M
R
M
M
M
M
M
M
M
M
M
M
M
M
M
M
"}
(14,1,1) = {"
M
M
M
M
M
M
M
M
R
M
M
M
R
M
M
M
R
M
M
M
R
M
M
M
M
M
M
M
M
M
M
M
M
M
M
"}
(15,1,1) = {"
M
M
R
M
M
R
M
M
M
R
M
M
M
M
M
M
M
M
M
M
M
M
M
M
R
M
M
M
M
M
M
M
M
M
M
"}
(16,1,1) = {"
M
M
M
M
M
R
M
M
M
M
M
M
M
R
M
M
M
M
M
M
M
M
R
R
M
M
M
M
M
M
M
M
R
M
M
"}
(17,1,1) = {"
M
M
M
M
M
R
M
M
M
M
M
M
M
R
M
R
M
M
R
M
R
M
M
M
M
M
M
M
M
M
M
M
R
M
M
"}
(18,1,1) = {"
M
M
M
M
M
R
R
M
M
M
R
R
R
R
M
R
M
M
M
M
M
R
M
M
M
M
M
M
M
M
M
M
R
M
M
"}
(19,1,1) = {"
M
R
M
M
M
M
M
M
M
M
M
M
M
M
R
M
M
M
M
M
M
M
M
M
M
M
M
M
M
M
M
M
M
M
M
"}
(20,1,1) = {"
M
R
M
M
R
M
M
M
M
M
M
M
M
M
R
M
M
M
M
M
M
M
R
M
M
M
M
M
M
M
M
M
R
M
M
"}
(21,1,1) = {"
M
M
M
M
M
R
M
M
M
M
M
M
M
M
M
R
R
M
M
M
M
M
M
M
R
M
M
M
M
M
M
M
R
M
M
"}
(22,1,1) = {"
M
M
M
M
R
M
M
M
M
M
M
M
R
M
M
R
M
M
M
M
M
M
M
M
M
R
M
M
M
M
M
M
R
M
M
"}
(23,1,1) = {"
M
M
M
M
M
M
M
M
M
R
M
M
M
M
M
R
R
R
M
M
M
M
M
M
M
R
M
M
M
M
M
M
R
M
M
"}
(24,1,1) = {"
M
M
M
M
R
M
M
M
M
R
M
M
M
M
M
M
M
M
M
M
M
M
M
M
M
M
R
M
M
M
M
M
M
M
M
"}
(25,1,1) = {"
M
M
M
M
M
R
M
R
M
R
R
R
M
M
M
M
M
M
M
M
M
M
M
M
M
M
R
R
M
M
M
M
M
M
M
"}
(26,1,1) = {"
M
M
M
M
M
M
M
M
M
M
M
R
M
M
M
R
R
M
M
R
M
M
R
M
M
M
M
M
M
M
M
M
M
M
M
"}
(27,1,1) = {"
M
M
R
R
M
M
M
M
M
M
M
R
M
R
R
M
M
M
R
M
M
M
M
M
M
M
M
M
M
M
M
M
M
M
M
"}
(28,1,1) = {"
M
M
M
M
M
M
M
M
M
M
M
M
M
M
M
M
M
M
M
M
M
M
M
M
M
M
M
M
M
M
M
M
M
M
M
"}
(29,1,1) = {"
M
M
M
M
M
M
M
R
M
M
M
R
M
M
R
M
M
R
M
M
M
M
M
M
M
M
M
M
M
M
M
M
M
R
M
"}
(30,1,1) = {"
M
M
M
M
M
M
M
R
M
M
M
M
M
M
M
M
M
M
M
M
M
M
M
M
M
M
M
M
M
M
M
R
M
M
M
"}

(1,1,2) = {"
B
B
B
B
B
B
B
B
B
B
B
B
B
B
B
B
B
B
B
B
a
a
a
a
a
a
a
a
a
a
z
z
a
a
a
"}
(2,1,2) = {"
B
B
g
g
g
g
g
g
g
g
B
B
B
B
B
B
B
B
B
a
a
a
a
a
a
a
a
a
a
a
z
z
a
a
a
"}
(3,1,2) = {"
B
B
B
B
x
g
g
g
t
g
g
B
B
B
B
B
B
B
z
z
z
a
a
a
a
a
a
a
a
z
a
a
a
a
a
"}
(4,1,2) = {"
a
B
B
B
B
S
P
g
Y
g
g
g
B
B
B
B
B
B
B
B
a
a
H
a
a
z
z
a
a
z
a
a
z
z
a
"}
(5,1,2) = {"
a
a
B
B
B
U
u
g
g
g
E
g
B
B
B
B
B
B
B
B
B
a
a
a
z
a
z
a
a
a
a
a
a
z
a
"}
(6,1,2) = {"
a
a
B
B
B
B
p
Z
g
g
g
g
B
B
B
B
B
B
B
B
z
a
a
a
z
a
z
a
a
z
a
a
a
z
a
"}
(7,1,2) = {"
a
a
a
B
B
B
G
g
g
g
g
g
B
B
B
B
B
B
B
B
a
a
a
a
z
z
H
H
a
z
a
a
a
z
a
"}
(8,1,2) = {"
a
a
a
z
B
B
z
g
g
g
g
g
g
B
B
B
B
B
B
z
z
a
a
a
a
z
a
a
a
z
a
a
a
a
z
"}
(9,1,2) = {"
a
a
H
a
a
B
B
g
g
g
g
g
B
B
B
a
B
B
B
B
z
a
a
a
z
a
z
a
a
a
a
a
a
a
a
"}
(10,1,2) = {"
a
a
a
a
z
z
B
B
g
g
g
z
C
z
B
a
B
B
B
z
z
a
a
z
a
z
a
a
z
a
H
a
a
a
a
"}
(11,1,2) = {"
a
a
a
a
a
a
B
N
T
T
g
h
W
a
z
a
a
a
a
a
a
z
z
a
a
a
z
z
z
z
z
a
a
a
a
"}
(12,1,2) = {"
a
a
a
a
a
a
z
a
z
a
a
z
a
a
a
z
a
z
a
a
z
z
z
a
a
a
a
a
z
z
a
a
a
a
a
"}
(13,1,2) = {"
a
a
a
a
z
z
z
a
a
a
a
z
a
a
z
a
z
a
a
z
a
a
a
z
z
a
a
a
a
a
z
z
a
a
a
"}
(14,1,2) = {"
a
a
a
a
a
a
a
z
z
z
z
z
a
a
a
a
z
z
a
a
a
a
a
a
a
a
a
a
a
a
a
a
z
z
z
"}
(15,1,2) = {"
a
H
a
a
z
a
a
a
a
a
a
a
a
a
z
z
z
z
z
z
a
a
a
a
a
a
z
z
z
a
a
z
a
z
a
"}
(16,1,2) = {"
a
a
a
a
z
a
a
a
z
z
a
a
a
a
z
a
z
z
z
a
a
H
a
a
z
a
a
a
a
z
a
z
a
a
z
"}
(17,1,2) = {"
a
a
a
z
z
a
a
a
a
z
z
z
z
z
a
a
z
a
z
a
z
a
a
z
a
a
a
a
z
a
z
a
a
a
z
"}
(18,1,2) = {"
a
a
a
H
a
a
a
a
B
a
a
z
a
z
a
a
a
a
a
a
z
z
a
a
z
a
z
z
a
z
z
a
a
z
a
"}
(19,1,2) = {"
a
a
a
a
a
a
a
B
a
a
a
a
a
a
a
a
a
z
z
z
z
z
a
a
a
a
a
a
a
a
z
a
s
z
a
"}
(20,1,2) = {"
a
a
a
a
z
a
B
a
a
a
a
z
a
z
a
z
z
z
a
a
z
a
a
a
z
a
a
a
a
z
z
a
z
a
a
"}
(21,1,2) = {"
a
a
a
a
z
B
B
B
a
a
a
a
a
z
a
H
a
a
a
a
a
a
z
z
a
a
z
a
a
z
a
a
z
a
a
"}
(22,1,2) = {"
a
a
a
a
B
B
B
B
B
B
a
z
a
z
a
z
a
a
a
z
H
z
a
a
a
a
a
s
z
a
a
a
z
a
a
"}
(23,1,2) = {"
a
a
a
B
B
B
B
B
B
a
z
a
a
z
a
a
a
a
a
a
a
z
z
a
a
a
a
z
a
a
H
a
z
a
a
"}
(24,1,2) = {"
a
a
a
B
B
B
B
B
a
a
z
z
a
z
a
a
a
a
a
a
z
z
a
a
a
a
a
z
a
a
a
a
z
a
a
"}
(25,1,2) = {"
a
a
a
B
B
B
B
B
z
a
z
z
a
z
a
z
a
z
z
z
a
a
a
a
a
a
a
z
a
a
a
z
z
a
a
"}
(26,1,2) = {"
a
a
a
B
B
B
B
B
z
a
a
a
a
a
a
a
H
a
a
a
a
a
a
a
a
a
a
a
a
a
z
z
a
a
a
"}
(27,1,2) = {"
a
a
B
B
B
B
B
a
a
a
a
a
a
a
a
a
a
a
a
a
a
a
H
a
a
a
z
a
a
z
z
z
a
a
a
"}
(28,1,2) = {"
a
a
B
B
B
a
a
a
a
a
a
a
a
a
a
a
a
a
a
a
a
a
a
a
a
z
z
a
a
a
H
a
a
a
a
"}
(29,1,2) = {"
a
a
a
a
a
a
a
a
a
a
a
a
a
a
a
a
a
a
a
a
a
a
a
a
z
s
a
a
a
a
a
a
a
a
a
"}
(30,1,2) = {"
a
a
a
a
a
a
a
a
a
a
a
a
a
a
a
a
a
a
a
a
a
a
a
a
a
a
a
a
a
a
a
a
a
a
a
"}

(1,1,3) = {"
B
B
B
g
g
g
g
g
g
g
g
B
B
B
B
B
B
B
B
B
F
F
F
F
F
F
F
F
F
F
F
F
F
F
F
"}
(2,1,3) = {"
B
B
B
g
F
F
F
F
F
F
g
g
B
B
B
B
B
B
B
F
F
F
F
F
F
F
F
F
F
F
F
F
F
F
F
"}
(3,1,3) = {"
B
B
B
g
g
F
F
F
F
F
F
g
B
B
B
B
B
B
F
F
F
F
F
F
F
F
F
F
F
F
F
F
F
F
F
"}
(4,1,3) = {"
F
B
B
B
g
g
F
F
F
F
F
B
B
B
B
B
B
B
B
B
F
F
F
F
F
F
F
F
F
F
F
F
F
F
F
"}
(5,1,3) = {"
F
F
B
B
B
g
g
F
F
F
q
g
B
B
B
B
B
B
B
B
B
F
F
F
F
F
F
F
F
F
F
F
F
F
F
"}
(6,1,3) = {"
F
F
B
B
B
B
g
F
F
F
F
g
B
B
B
B
B
B
B
B
F
F
F
F
F
F
F
F
F
F
F
F
F
F
F
"}
(7,1,3) = {"
F
F
F
B
B
B
g
F
F
F
F
g
B
B
B
B
B
B
B
B
F
F
F
F
F
F
F
F
F
F
F
F
F
F
F
"}
(8,1,3) = {"
F
F
F
F
B
B
g
g
F
F
F
g
B
B
B
B
B
B
B
F
F
F
F
F
F
F
F
F
F
F
F
F
F
F
F
"}
(9,1,3) = {"
F
F
F
F
F
B
B
g
F
g
g
g
B
B
B
F
B
B
B
B
F
F
F
F
F
F
F
F
F
F
F
F
F
F
F
"}
(10,1,3) = {"
F
F
F
F
F
F
B
g
g
B
B
B
F
F
B
F
B
B
B
F
F
F
F
F
F
F
F
F
F
F
F
F
F
F
F
"}
(11,1,3) = {"
F
F
F
F
F
F
B
B
B
B
B
F
F
F
F
F
F
F
F
F
F
F
F
F
F
F
F
F
F
F
F
F
F
F
F
"}
(12,1,3) = {"
F
F
F
F
F
F
F
B
B
B
B
F
F
F
F
F
F
F
F
F
F
F
F
F
F
F
F
F
F
F
F
F
F
F
F
"}
(13,1,3) = {"
F
F
F
F
F
F
F
B
B
B
B
F
F
F
F
F
F
F
F
F
F
F
F
F
F
F
F
F
F
F
F
F
F
F
F
"}
(14,1,3) = {"
F
F
F
F
F
F
F
B
B
B
B
F
F
F
F
F
F
F
F
F
F
F
F
F
F
F
F
F
F
F
F
F
F
F
F
"}
(15,1,3) = {"
F
F
F
F
F
F
F
B
B
B
B
F
F
F
F
F
F
F
F
F
F
F
F
F
F
F
F
F
F
F
F
F
F
F
F
"}
(16,1,3) = {"
F
F
F
F
F
F
F
B
B
B
B
F
F
F
F
F
F
F
F
F
F
F
F
F
F
F
F
F
F
F
F
F
F
F
F
"}
(17,1,3) = {"
F
F
F
F
F
F
F
B
B
B
F
F
F
F
F
F
F
F
F
F
F
F
F
F
F
F
F
F
F
F
F
F
F
F
F
"}
(18,1,3) = {"
F
F
F
F
F
F
F
B
B
B
F
F
F
F
F
F
F
F
F
F
F
F
F
F
F
F
F
F
F
F
F
F
F
F
F
"}
(19,1,3) = {"
F
F
F
F
F
F
F
B
B
B
F
F
F
F
F
F
F
F
F
F
F
F
F
F
F
F
F
F
F
F
F
F
F
F
F
"}
(20,1,3) = {"
F
F
F
F
F
F
B
B
B
B
F
F
F
F
F
F
F
F
F
F
F
F
F
F
F
F
F
F
F
F
F
F
F
F
F
"}
(21,1,3) = {"
F
F
F
F
F
B
B
B
B
B
F
F
F
F
F
F
F
F
F
F
F
F
F
F
F
F
F
F
F
F
F
F
F
F
F
"}
(22,1,3) = {"
F
F
F
B
B
B
B
B
B
B
F
F
F
F
F
F
F
F
F
F
F
F
F
F
F
F
F
F
F
F
F
F
F
F
F
"}
(23,1,3) = {"
F
F
F
B
B
B
B
B
B
B
F
F
F
F
F
F
F
F
F
F
F
F
F
F
F
F
F
F
F
F
F
F
F
F
F
"}
(24,1,3) = {"
F
F
B
B
B
B
B
B
B
B
F
F
F
F
F
F
F
F
F
F
F
F
F
F
F
F
F
F
F
F
F
F
F
F
F
"}
(25,1,3) = {"
F
F
B
B
B
B
B
B
B
B
F
F
F
F
F
F
F
F
F
F
F
F
F
F
F
F
F
F
F
F
F
F
F
F
F
"}
(26,1,3) = {"
F
F
B
B
B
B
B
B
B
F
F
F
F
F
F
F
F
F
F
F
F
F
F
F
F
F
F
F
F
F
F
F
F
F
F
"}
(27,1,3) = {"
F
F
B
B
B
B
B
B
F
F
F
F
F
F
F
F
F
F
F
F
F
F
F
F
F
F
F
F
F
F
F
F
F
F
F
"}
(28,1,3) = {"
F
F
B
B
B
B
B
B
F
F
F
F
F
F
F
F
F
F
F
F
F
F
F
F
F
F
F
F
F
F
F
F
F
F
F
"}
(29,1,3) = {"
F
F
B
B
B
B
B
F
F
F
F
F
F
F
F
F
F
F
F
F
F
F
F
F
F
F
F
F
F
F
F
F
F
F
F
"}
(30,1,3) = {"
F
F
B
B
F
F
F
F
F
F
F
F
F
F
F
F
F
F
F
F
F
F
F
F
F
F
F
F
F
F
F
F
F
F
F
"}
