"a" = (/obj/effect/decal/cleanable/blood/tracks,/turf/open/floor/rogue/naturalstone,/area/rogue)
"b" = (/obj/item/natural/rock,/turf/open/floor/rogue/naturalstone,/area/rogue)
"c" = (/obj/structure/spider/cocoon,/turf/open/floor/rogue/naturalstone,/area/rogue)
"d" = (/obj/effect/decal/cleanable/blood/tracks{dir = 1},/turf/open/floor/rogue/naturalstone,/area/rogue)
"e" = (/obj/structure/spider/stickyweb,/turf/open/floor/rogue/naturalstone,/area/rogue)
"h" = (/obj/structure/table/wood,/turf/open/floor/rogue/herringbone,/area/rogue)
"i" = (/obj/structure/spider/stickyweb,/obj/effect/decal/cleanable/blood/tracks,/turf/open/floor/rogue/naturalstone,/area/rogue)
"l" = (/obj/structure/table/wood,/obj/item/flashlight/flare/torch/metal,/turf/open/floor/rogue/herringbone,/area/rogue)
"n" = (/mob/living/simple_animal/hostile/retaliate/rogue/spider/mutated,/turf/open/floor/rogue/naturalstone,/area/rogue)
"o" = (/obj/structure/table/wood,/obj/effect/decal/cleanable/cobweb{dir = 4},/turf/open/floor/rogue/herringbone,/area/rogue)
"r" = (/obj/item/clothing/head/roguetown/helmet/skullcap,/turf/open/floor/rogue/naturalstone,/area/rogue)
"t" = (/obj/machinery/light/rogue/firebowl/standing/blue,/obj/structure/fluff/walldeco/psybanner{pixel_y = 32},/obj/effect/decal/cleanable/cobweb{dir = 1},/turf/open/floor/rogue/herringbone,/area/rogue)
"w" = (/obj/effect/decal/cleanable/cobweb{dir = 4},/turf/open/floor/rogue/naturalstone,/area/rogue)
"x" = (/obj/structure/table/wood,/obj/item/clothing/neck/roguetown/psicross,/turf/open/floor/rogue/herringbone,/area/rogue)
"z" = (/obj/structure/mineral_door/bars,/turf/open/floor/rogue/herringbone,/area/rogue)
"C" = (/turf/closed/mineral/rogue/bedrock,/area/rogue)
"D" = (/obj/structure/bars/cemetery,/turf/open/floor/rogue/herringbone,/area/rogue)
"E" = (/obj/structure/spider/cocoon,/obj/effect/decal/cleanable/blood/tracks{dir = 8},/turf/open/floor/rogue/naturalstone,/area/rogue)
"F" = (/turf/closed/mineral/random/rogue/high,/area/rogue)
"H" = (/obj/structure/spider/stickyweb/solo,/turf/open/floor/rogue/naturalstone,/area/rogue)
"I" = (/turf/open/floor/rogue/naturalstone,/area/rogue)
"J" = (/obj/structure/closet/crate/coffin,/obj/item/clothing/head/roguetown/crown/circlet/sleepless,/turf/open/floor/rogue/herringbone,/area/rogue)
"K" = (/obj/item/flashlight/flare/torch/lantern,/turf/open/floor/rogue/naturalstone,/area/rogue)
"L" = (/turf/open/water/swamp,/area/rogue)
"M" = (/obj/machinery/light/rogue/firebowl/standing/blue,/obj/structure/fluff/walldeco/psybanner{pixel_y = 32},/turf/open/floor/rogue/herringbone,/area/rogue)
"Q" = (/turf/closed/wall/mineral/rogue/craftstone,/area/rogue)
"R" = (/obj/effect/decal/cleanable/blood/tracks{dir = 8},/turf/open/floor/rogue/naturalstone,/area/rogue)
"S" = (/turf/open/floor/rogue/dirt,/area/rogue)
"T" = (/obj/effect/decal/cleanable/cobweb{icon_state = "cobweb2"},/turf/open/floor/rogue/naturalstone,/area/rogue)
"U" = (/obj/item/rogueweapon/pick,/turf/open/floor/rogue/naturalstone,/area/rogue)
"W" = (/turf/open/floor/rogue/herringbone,/area/rogue)
"Y" = (/turf/open/floor/rogue/dirt/road,/area/rogue)
"Z" = (/obj/effect/decal/cleanable/cobweb,/turf/open/floor/rogue/naturalstone,/area/rogue)

(1,1,1) = {"
SSSSSSSSSSSSYSSSSSSSSSSSSSSSSS
SSSCSLSSSSYYIYSYSSSLSSSSSSSSSS
LLCCCLLSYCCIIYCYYLLLLSSSSSSSSS
CCCCCCCLCCZIICCCCCLLLLLLLSCSSS
CCCeCCCCCIIICCCCCCCCCLLCCCCCSS
CCeIIICCCbIICCCCeIICCCCCCCCCCS
CeInIeCCCIIICCCIIIIICCCCCIICCS
CIIIIIeCCeIICCeIIIICCeKeIIICCS
CIIIIIICCCIIICeIIICCernIIeICCS
CIICCwIICCeIICIICICCeERRIeCCCS
CIIICCIICCCIIIIICIICCCCaIICCCS
CCIICCCIIICCIIICCIIICCCiIICCSS
CCIIHCCCCICCICCCCCIIICCaIICCCS
CIIICCIIIIIIIICCIIIICCCaIbTCCC
CIICCCCIICIICIIIICbCCIIaIIICCC
CICCCCCeICCCCCIIICCCCIIaIIICCC
CICCeCCCeIICCCCIIIICCeIaIICCCC
CIeecCCCCIIInCCCeeICCCIaIICCCC
CIIIIeeCCCCIIICCCCICCCCaCeCCCC
CIIIIIeCCCCCIICCCCCCCICaCCCCCC
CCICCIIICnIIICCCIIIIIICdIIICCS
CCCCCCIIIIICCCCCIIeCIIIdInCCCS
CCbICIIICICCeeeIIeCCeIIIIICCCS
CCIICIeCCCCCeIIIIeCCCenIIICCSS
CIIIeICCCeIIIIICIIbCCCCeIeCCSS
CIIeCCCIIeeeCICCIIIUFCCCeeCCCS
CCIeCCIIeCCCCCCCCCCCFFCCeeCCCC
CHIICnIICCCCCCCICCCCCFFCCIeCCC
CIICCIIICCCIIIIIHIIeCCCCeInCCS
CIICCICCCCQQDzDQQIInICCCeeeeCC
CIIICICCCCQMWWWtQCeIInIeeeeCCC
CIIICIICCCQWWWWWQCCnIIIIIeCCCC
CCIIIIbCCCQWWWWWQCCIIenIIICCSC
CCCIIICCCCQoxJlhQCCCCCeecCCCSS
CCCCCCCCCCQQQQQQQCCCCCCCCCCCCC
"}
