//MAP CONVERTED BY dmm2tgm.py THIS HEADER COMMENT PREVENTS RECONVERSION, DO NOT REMOVE
"a" = (
/obj/structure/roguetent,
/turf/open/floor/rogue/dirt/road,
/area/rogue/outdoors/bog)
"b" = (
/turf/open/floor/rogue/twig,
/area/rogue/outdoors/bog)
"c" = (
/obj/structure/bed/rogue/shit,
/turf/open/floor/rogue/twig,
/area/rogue/outdoors/bog)
"d" = (
/turf/open/water/swamp,
/area/rogue/outdoors/bog)
"e" = (
/obj/structure/fluff/railing/fence{
	dir = 1
	},
/obj/structure/fluff/railing/fence{
	dir = 8
	},
/turf/open/floor/rogue/dirt/road,
/area/rogue/outdoors/bog)
"f" = (
/obj/machinery/light/rogue/campfire/densefire,
/turf/open/floor/rogue/dirt/road,
/area/rogue/outdoors/bog)
"g" = (
/obj/effect/spawner/roguemap/grass_low,
/turf/open/floor/rogue/dirt/road,
/area/rogue/outdoors/bog)
"h" = (
/obj/structure/fluff/railing/fence{
	dir = 4
	},
/turf/open/floor/rogue/dirt/road,
/area/rogue/outdoors/bog)
"i" = (
/mob/living/carbon/human/species/orc/marauder,
/turf/open/floor/rogue/dirt/road,
/area/rogue/outdoors/bog)
"j" = (
/obj/structure/chair/bench/ancientlog,
/turf/open/floor/rogue/dirt/road,
/area/rogue/outdoors/bog)
"k" = (
/obj/structure/fluff/railing/fence{
	dir = 1
	},
/turf/open/floor/rogue/dirt/road,
/area/rogue/outdoors/bog)
"l" = (
/obj/item/restraints/legcuffs/beartrap/armed/camouflage,
/obj/structure/flora/roguegrass,
/turf/open/floor/rogue/cobblerock,
/area/rogue/outdoors/bog)
"m" = (
/obj/structure/table/wood/treestump,
/turf/open/floor/rogue/dirt,
/area/rogue/outdoors/bog)
"n" = (
/obj/machinery/light/rogue/firebowl/stump,
/turf/open/floor/rogue/dirt/road,
/area/rogue/outdoors/bog)
"o" = (
/mob/living/carbon/human/species/orc/tribal,
/turf/open/floor/rogue/cobblerock,
/area/rogue/outdoors/bog)
"p" = (
/mob/living/carbon/human/species/orc/warlord/skilled,
/turf/open/floor/rogue/twig,
/area/rogue/outdoors/bog)
"q" = (
/obj/structure/flora/roguetree/evil,
/turf/open/floor/rogue/dirt/road,
/area/rogue/outdoors/bog)
"r" = (
/obj/machinery/light/rogue/firebowl/stump,
/turf/open/floor/rogue/dirt,
/area/rogue/outdoors/bog)
"s" = (
/obj/structure/flora/roguegrass,
/turf/open/floor/rogue/dirt,
/area/rogue/outdoors/bog)
"t" = (
/obj/item/reagent_containers/food/snacks/rogue/meat/steak,
/turf/open/floor/rogue/twig,
/area/rogue/outdoors/bog)
"u" = (
/mob/living/carbon/human/species/goblin/npc/ambush,
/turf/open/floor/rogue/twig,
/area/rogue/outdoors/bog)
"v" = (
/obj/structure/fluff/railing/fence{
	dir = 1
	},
/obj/structure/fluff/railing/fence{
	dir = 4
	},
/turf/open/floor/rogue/dirt/road,
/area/rogue/outdoors/bog)
"w" = (
/obj/structure/closet/crate/chest/wicker,
/obj/item/reagent_containers/food/snacks/rogue/meat/steak,
/obj/item/reagent_containers/food/snacks/rogue/meat/steak,
/turf/open/floor/rogue/twig,
/area/rogue/outdoors/bog)
"x" = (
/obj/structure/table/wood/plain,
/obj/item/clothing/head/roguetown/crown/circlet,
/turf/open/floor/rogue/twig,
/area/rogue/outdoors/bog)
"y" = (
/turf/closed/wall/mineral/rogue/tent,
/area/rogue/outdoors/bog)
"z" = (
/obj/structure/fluff/railing/fence{
	dir = 8
	},
/turf/open/floor/rogue/cobblerock,
/area/rogue/outdoors/bog)
"A" = (
/obj/structure/flora/roguetree/evil,
/turf/open/floor/rogue/dirt,
/area/rogue/outdoors/bog)
"B" = (
/obj/effect/decal/cleanable/blood/gibs/up,
/obj/item/natural/hide,
/obj/item/rope/chain,
/turf/open/floor/rogue/twig,
/area/rogue/outdoors/bog)
"C" = (
/obj/item/reagent_containers/food/snacks/rogue/meat/steak,
/turf/open/floor/rogue/dirt/road,
/area/rogue/outdoors/bog)
"D" = (
/obj/structure/table/wood/treestump,
/turf/open/floor/rogue/dirt/road,
/area/rogue/outdoors/bog)
"E" = (
/obj/item/natural/poo/horse,
/turf/open/floor/rogue/dirt/road,
/area/rogue/outdoors/bog)
"F" = (
/turf/open/floor/rogue/dirt,
/area/rogue/outdoors/bog)
"G" = (
/obj/structure/roguetent,
/turf/open/floor/rogue/twig,
/area/rogue/outdoors/bog)
"H" = (
/obj/structure/fluff/railing/fence,
/turf/open/floor/rogue/dirt,
/area/rogue/outdoors/bog)
"I" = (
/mob/living/carbon/human/species/goblin/npc/ambush,
/turf/open/floor/rogue/cobblerock,
/area/rogue/outdoors/bog)
"J" = (
/turf/open/floor/rogue/cobblerock,
/area/rogue/outdoors/bog)
"L" = (
/obj/structure/fluff/dryingrack,
/obj/item/reagent_containers/food/snacks/rogue/meat/steak,
/obj/effect/decal/cleanable/blood/gibs/core,
/turf/open/floor/rogue/dirt/road,
/area/rogue/outdoors/bog)
"M" = (
/obj/structure/fluff/railing/fence{
	dir = 8
	},
/turf/open/floor/rogue/dirt/road,
/area/rogue/outdoors/bog)
"N" = (
/obj/structure/table/wood/plain,
/obj/item/reagent_containers/glass/cup/steel,
/turf/open/floor/rogue/twig,
/area/rogue/outdoors/bog)
"O" = (
/obj/structure/fluff/dryingrack,
/obj/effect/decal/cleanable/blood/gibs/core,
/obj/item/natural/hide,
/turf/open/floor/rogue/dirt/road,
/area/rogue/outdoors/bog)
"P" = (
/obj/structure/closet/crate/chest/wicker,
/obj/item/grown/log/tree/stick,
/obj/item/grown/log/tree/stick,
/obj/item/grown/log/tree/stick,
/turf/open/floor/rogue/twig,
/area/rogue/outdoors/bog)
"Q" = (
/obj/machinery/light/rogue/firebowl/standing,
/turf/open/floor/rogue/twig,
/area/rogue/outdoors/bog)
"R" = (
/turf/closed/wall/mineral/rogue/wood,
/area/rogue/outdoors/bog)
"S" = (
/obj/item/needle/thorn,
/turf/open/floor/rogue/dirt/road,
/area/rogue/outdoors/bog)
"T" = (
/turf/open/floor/rogue/dirt/road,
/area/rogue/outdoors/bog)
"U" = (
/obj/item/restraints/legcuffs/beartrap/armed/camouflage,
/turf/open/floor/rogue/dirt/road,
/area/rogue/outdoors/bog)
"V" = (
/mob/living/carbon/human/species/goblin/npc/ambush,
/turf/open/floor/rogue/dirt/road,
/area/rogue/outdoors/bog)
"W" = (
/obj/structure/closet/crate/chest/wicker,
/obj/item/ingot/steel,
/obj/item/ingot/steel,
/turf/open/floor/rogue/twig,
/area/rogue/outdoors/bog)
"X" = (
/obj/item/restraints/legcuffs/beartrap/armed/camouflage,
/obj/structure/flora/roguegrass,
/turf/open/floor/rogue/dirt/road,
/area/rogue/outdoors/bog)
"Y" = (
/obj/structure/fluff/railing/fence{
	dir = 4
	},
/turf/open/floor/rogue/dirt,
/area/rogue/outdoors/bog)
"Z" = (
/obj/structure/flora/roguegrass,
/turf/open/floor/rogue/dirt/road,
/area/rogue/outdoors/bog)

(1,1,1) = {"
T
F
d
d
k
T
T
T
T
F
F
F
T
T
T
T
T
T
Z
T
T
T
T
T
T
T
F
d
d
d
d
d
d
d
d
"}
(2,1,1) = {"
T
F
F
d
k
T
T
F
F
F
T
F
F
T
Z
T
T
g
T
T
T
T
R
T
b
y
R
F
d
d
d
d
d
d
d
"}
(3,1,1) = {"
T
T
d
d
k
T
d
d
d
T
D
T
F
T
T
T
Z
T
T
Z
F
T
y
T
c
c
y
F
F
F
d
d
d
d
d
"}
(4,1,1) = {"
T
T
d
d
k
T
d
d
T
Z
T
T
T
U
T
T
T
T
F
F
F
Z
y
T
T
b
b
T
T
T
F
d
d
d
d
"}
(5,1,1) = {"
F
F
d
d
k
d
d
d
q
T
F
T
R
y
y
R
Z
T
F
F
F
F
b
T
T
b
T
T
R
y
R
F
F
d
d
"}
(6,1,1) = {"
T
F
d
d
k
d
d
Z
T
T
F
T
y
c
c
y
T
T
F
F
F
F
R
b
b
T
R
T
G
b
y
F
d
d
d
"}
(7,1,1) = {"
T
F
F
d
k
T
d
T
T
F
F
T
y
b
u
y
T
T
T
F
F
F
F
J
J
J
g
T
y
B
y
F
d
d
d
"}
(8,1,1) = {"
T
F
F
d
k
T
T
T
F
F
F
T
y
b
c
y
Z
T
T
J
J
F
F
T
T
T
T
J
R
y
R
F
F
d
d
"}
(9,1,1) = {"
T
F
F
d
k
T
T
g
F
F
e
M
R
G
y
R
M
z
J
R
y
y
y
y
y
y
R
J
T
F
F
d
d
d
d
"}
(10,1,1) = {"
T
F
F
d
k
T
F
F
F
T
k
L
T
T
J
J
T
T
Z
y
c
c
c
c
b
W
y
T
F
F
F
d
d
d
d
"}
(11,1,1) = {"
F
F
T
r
F
s
F
F
m
Z
k
T
V
T
J
g
I
T
T
y
b
b
Q
b
b
b
y
T
J
J
T
F
F
F
d
"}
(12,1,1) = {"
T
X
Z
J
J
J
T
T
J
J
J
T
T
o
T
T
J
J
T
y
b
b
b
b
b
N
y
T
Z
J
T
T
F
F
d
"}
(13,1,1) = {"
J
T
J
J
J
J
l
J
T
T
T
J
J
J
T
f
T
J
J
G
b
b
b
p
b
c
y
Z
F
F
J
T
T
U
F
"}
(14,1,1) = {"
Z
F
F
n
X
F
F
g
T
T
T
T
J
i
T
T
T
J
C
y
b
b
b
b
b
x
y
F
F
T
T
T
T
T
T
"}
(15,1,1) = {"
T
d
d
d
k
F
F
T
s
T
T
k
J
J
J
T
J
I
T
y
b
b
Q
b
b
b
y
F
F
F
A
F
J
D
T
"}
(16,1,1) = {"
T
F
d
d
k
T
T
T
F
F
T
k
s
F
J
J
T
O
T
y
c
c
c
c
P
w
y
F
F
F
F
F
J
T
T
"}
(17,1,1) = {"
T
T
d
d
k
T
T
T
Z
F
T
k
F
F
F
V
T
T
S
R
y
y
y
y
y
y
R
F
A
F
F
F
J
T
Z
"}
(18,1,1) = {"
T
T
d
d
k
T
T
j
T
F
T
k
r
F
F
F
T
Z
F
F
F
T
T
T
H
F
F
F
F
F
A
F
T
Z
Z
"}
(19,1,1) = {"
T
d
d
d
k
T
T
T
T
F
F
v
h
T
F
F
T
F
F
F
T
g
T
T
H
F
F
F
F
A
F
Z
T
J
T
"}
(20,1,1) = {"
T
d
d
d
k
T
T
Z
T
F
F
T
T
k
F
F
F
F
F
F
R
y
y
y
R
F
F
A
F
F
T
T
T
J
E
"}
(21,1,1) = {"
T
F
F
d
k
T
D
T
g
F
F
T
T
T
F
F
F
h
F
T
y
c
u
c
y
T
T
F
F
F
T
E
J
T
T
"}
(22,1,1) = {"
T
T
F
d
k
T
T
T
F
F
F
F
T
T
T
T
T
Z
T
T
a
b
b
b
y
T
T
T
T
Z
T
T
T
Z
T
"}
(23,1,1) = {"
T
T
F
d
k
Z
T
T
F
F
F
T
T
D
T
T
Z
T
k
T
y
c
t
c
y
T
T
D
T
T
Z
T
T
T
T
"}
(24,1,1) = {"
T
T
F
d
k
T
T
D
Z
T
F
F
q
T
U
T
T
T
v
h
R
y
y
y
R
T
T
T
T
Z
T
Z
T
E
T
"}
(25,1,1) = {"
T
T
d
d
v
h
h
h
h
Y
Y
Y
h
h
h
h
h
h
h
h
h
h
h
h
h
h
h
h
h
h
h
h
h
h
h
"}
(26,1,1) = {"
T
T
F
d
d
F
F
F
F
F
d
T
T
d
d
d
F
F
F
d
d
d
d
T
d
d
d
F
T
T
F
F
d
d
d
"}
(27,1,1) = {"
T
T
d
d
d
d
F
F
F
d
d
d
d
d
d
d
F
F
F
F
F
F
d
d
d
d
d
d
F
T
d
d
d
d
d
"}
(28,1,1) = {"
T
T
T
F
F
d
d
d
d
d
d
d
d
d
d
d
d
d
F
F
T
T
F
d
d
d
d
F
T
d
d
d
F
d
d
"}
(29,1,1) = {"
T
T
T
T
F
F
F
F
F
F
d
d
F
F
F
F
F
F
F
T
T
T
d
d
d
d
d
d
d
d
d
F
T
F
d
"}
(30,1,1) = {"
T
T
T
T
T
T
T
T
T
F
F
F
F
F
T
T
T
T
T
T
T
T
T
T
T
F
F
F
F
F
T
T
T
F
F
"}
