//MAP CONVERTED BY dmm2tgm.py THIS HEADER COMMENT PREVENTS RECONVERSION, DO NOT REMOVE
"ad" = (
/obj/structure/fluff/railing/fence{
	dir = 1
	},
/obj/structure/fluff/railing/fence{
	dir = 8
	},
/turf/open/floor/rogue/dirt/road,
/area/rogue/outdoors/bog)
"ax" = (
/obj/item/restraints/legcuffs/beartrap/armed/camouflage,
/obj/structure/flora/roguegrass,
/turf/open/floor/rogue/dirt/road,
/area/rogue/outdoors/bog)
"cf" = (
/turf/open/water/swamp,
/area/rogue/outdoors/bog)
"ci" = (
/mob/living/carbon/human/species/orc/warlord/skilled,
/turf/open/floor/rogue/twig,
/area/rogue/outdoors/bog)
"cj" = (
/obj/structure/fluff/railing/fence{
	dir = 4
	},
/turf/open/floor/rogue/dirt,
/area/rogue/outdoors/bog)
"er" = (
/obj/structure/roguetent,
/turf/open/floor/rogue/twig,
/area/rogue/outdoors/bog)
"fS" = (
/obj/item/reagent_containers/food/snacks/rogue/meat/steak,
/turf/open/floor/rogue/twig,
/area/rogue/outdoors/bog)
"gV" = (
/turf/open/floor/rogue/dirt,
/area/rogue/outdoors/bog)
"hC" = (
/obj/machinery/light/rogue/firebowl/stump,
/turf/open/floor/rogue/dirt/road,
/area/rogue/outdoors/bog)
"ko" = (
/obj/item/restraints/legcuffs/beartrap/armed/camouflage,
/obj/structure/flora/roguegrass,
/turf/open/floor/rogue/cobblerock,
/area/rogue/outdoors/bog)
"ky" = (
/obj/structure/closet/crate/chest/wicker,
/obj/item/grown/log/tree/stick,
/obj/item/grown/log/tree/stick,
/obj/item/grown/log/tree/stick,
/turf/open/floor/rogue/twig,
/area/rogue/outdoors/bog)
"lN" = (
/obj/item/restraints/legcuffs/beartrap/armed/camouflage,
/turf/open/floor/rogue/dirt/road,
/area/rogue/outdoors/bog)
"mC" = (
/mob/living/carbon/human/species/orc/tribal,
/turf/open/floor/rogue/cobblerock,
/area/rogue/outdoors/bog)
"mG" = (
/obj/structure/table/wood/treestump,
/turf/open/floor/rogue/dirt/road,
/area/rogue/outdoors/bog)
"oK" = (
/obj/machinery/tanningrack,
/obj/effect/decal/cleanable/blood/gibs/core,
/obj/item/natural/hide,
/turf/open/floor/rogue/dirt/road,
/area/rogue/outdoors/bog)
"qa" = (
/obj/structure/fluff/railing/fence{
	dir = 8
	},
/obj/structure/fluff/railing/fence,
/turf/open/floor/rogue/dirt/road,
/area/rogue/outdoors/bog)
"qk" = (
/turf/closed/wall/mineral/rogue/wood,
/area/rogue/outdoors/bog)
"rD" = (
/obj/structure/bed/rogue/shit,
/turf/open/floor/rogue/twig,
/area/rogue/outdoors/bog)
"rJ" = (
/turf/open/floor/rogue/dirt/road,
/area/rogue/outdoors/bog)
"sB" = (
/obj/structure/fluff/railing/fence{
	dir = 4
	},
/turf/open/floor/rogue/dirt/road,
/area/rogue/outdoors/bog)
"sF" = (
/turf/open/floor/rogue/twig,
/area/rogue/outdoors/bog)
"ta" = (
/obj/structure/fluff/railing/fence{
	dir = 8
	},
/turf/open/floor/rogue/cobblerock,
/area/rogue/outdoors/bog)
"uV" = (
/obj/structure/flora/roguetree/evil,
/turf/open/floor/rogue/dirt/road,
/area/rogue/outdoors/bog)
"vl" = (
/obj/structure/closet/crate/chest/wicker,
/obj/item/ingot/steel,
/obj/item/ingot/steel,
/turf/open/floor/rogue/twig,
/area/rogue/outdoors/bog)
"vS" = (
/obj/structure/fluff/railing/fence{
	dir = 8
	},
/obj/structure/fluff/railing/fence{
	dir = 1
	},
/turf/open/floor/rogue/dirt/road,
/area/rogue/outdoors/bog)
"wf" = (
/obj/item/reagent_containers/food/snacks/rogue/meat/steak,
/turf/open/floor/rogue/dirt/road,
/area/rogue/outdoors/bog)
"xf" = (
/obj/structure/roguetent,
/turf/open/floor/rogue/dirt/road,
/area/rogue/outdoors/bog)
"Bk" = (
/obj/effect/spawner/roguemap/grass_low,
/turf/open/floor/rogue/dirt/road,
/area/rogue/outdoors/bog)
"Bs" = (
/obj/structure/fluff/railing/fence,
/obj/structure/fluff/railing/fence{
	dir = 4
	},
/turf/open/floor/rogue/dirt/road,
/area/rogue/outdoors/bog)
"BO" = (
/obj/structure/flora/roguegrass,
/turf/open/floor/rogue/dirt/road,
/area/rogue/outdoors/bog)
"De" = (
/obj/structure/flora/roguegrass,
/turf/open/floor/rogue/dirt,
/area/rogue/outdoors/bog)
"DJ" = (
/mob/living/carbon/human/species/orc/marauder,
/turf/open/floor/rogue/dirt/road,
/area/rogue/outdoors/bog)
"DQ" = (
/obj/structure/closet/crate/chest/wicker,
/obj/item/reagent_containers/food/snacks/rogue/meat/steak,
/obj/item/reagent_containers/food/snacks/rogue/meat/steak,
/turf/open/floor/rogue/twig,
/area/rogue/outdoors/bog)
"Ep" = (
/obj/machinery/light/rogue/campfire/densefire,
/turf/open/floor/rogue/dirt/road,
/area/rogue/outdoors/bog)
"GU" = (
/obj/structure/fluff/railing/fence,
/turf/open/floor/rogue/dirt/road,
/area/rogue/outdoors/bog)
"Ii" = (
/obj/structure/flora/roguetree/evil,
/turf/open/floor/rogue/dirt,
/area/rogue/outdoors/bog)
"Iz" = (
/obj/structure/fluff/railing/fence,
/turf/open/floor/rogue/dirt,
/area/rogue/outdoors/bog)
"JA" = (
/turf/open/floor/rogue/cobblerock,
/area/rogue/outdoors/bog)
"Kh" = (
/turf/closed/wall/mineral/rogue/tent,
/area/rogue/outdoors/bog)
"Ku" = (
/obj/structure/fluff/railing/fence{
	dir = 1
	},
/turf/open/floor/rogue/dirt/road,
/area/rogue/outdoors/bog)
"KG" = (
/obj/machinery/light/rogue/firebowl/stump,
/turf/open/floor/rogue/dirt,
/area/rogue/outdoors/bog)
"LI" = (
/obj/structure/table/wood/plain,
/obj/item/reagent_containers/glass/cup/steel,
/turf/open/floor/rogue/twig,
/area/rogue/outdoors/bog)
"Mi" = (
/mob/living/carbon/human/species/goblin/npc/ambush,
/turf/open/floor/rogue/twig,
/area/rogue/outdoors/bog)
"NP" = (
/obj/structure/chair/bench/ancientlog,
/turf/open/floor/rogue/dirt/road,
/area/rogue/outdoors/bog)
"OF" = (
/mob/living/carbon/human/species/goblin/npc/ambush,
/turf/open/floor/rogue/cobblerock,
/area/rogue/outdoors/bog)
"OO" = (
/obj/effect/decal/cleanable/blood/gibs/up,
/obj/item/natural/hide,
/obj/item/rope/chain,
/turf/open/floor/rogue/twig,
/area/rogue/outdoors/bog)
"Po" = (
/obj/item/needle/thorn,
/turf/open/floor/rogue/dirt/road,
/area/rogue/outdoors/bog)
"UE" = (
/obj/structure/table/wood/plain,
/obj/item/clothing/head/roguetown/crown/circlet,
/turf/open/floor/rogue/twig,
/area/rogue/outdoors/bog)
"Vm" = (
/obj/structure/fluff/railing/fence{
	dir = 1
	},
/obj/structure/fluff/railing/fence{
	dir = 4
	},
/turf/open/floor/rogue/dirt/road,
/area/rogue/outdoors/bog)
"Wd" = (
/obj/structure/table/wood/treestump,
/turf/open/floor/rogue/dirt,
/area/rogue/outdoors/bog)
"Yg" = (
/obj/machinery/tanningrack,
/obj/item/reagent_containers/food/snacks/rogue/meat/steak,
/obj/effect/decal/cleanable/blood/gibs/core,
/turf/open/floor/rogue/dirt/road,
/area/rogue/outdoors/bog)
"Yi" = (
/obj/machinery/light/rogue/firebowl/standing,
/turf/open/floor/rogue/twig,
/area/rogue/outdoors/bog)
"Yt" = (
/obj/structure/fluff/railing/fence{
	dir = 8
	},
/turf/open/floor/rogue/dirt/road,
/area/rogue/outdoors/bog)
"YY" = (
/mob/living/carbon/human/species/goblin/npc/ambush,
/turf/open/floor/rogue/dirt/road,
/area/rogue/outdoors/bog)

(1,1,1) = {"
rJ
rJ
cf
cf
rJ
rJ
cf
cf
rJ
rJ
rJ
rJ
rJ
rJ
rJ
rJ
cf
cf
cf
cf
rJ
cf
cf
rJ
rJ
rJ
rJ
rJ
rJ
rJ
rJ
rJ
rJ
rJ
rJ
rJ
cf
cf
cf
rJ
"}
(2,1,1) = {"
rJ
rJ
rJ
rJ
cf
cf
rJ
rJ
rJ
rJ
rJ
rJ
rJ
rJ
rJ
rJ
rJ
rJ
rJ
cf
cf
cf
cf
cf
rJ
rJ
rJ
rJ
rJ
cf
cf
cf
cf
cf
cf
cf
rJ
rJ
rJ
cf
"}
(3,1,1) = {"
rJ
rJ
rJ
cf
cf
rJ
cf
cf
cf
rJ
rJ
rJ
rJ
rJ
rJ
rJ
rJ
cf
cf
cf
rJ
rJ
rJ
rJ
cf
cf
cf
cf
cf
rJ
cf
cf
cf
cf
cf
cf
cf
cf
cf
cf
"}
(4,1,1) = {"
rJ
rJ
cf
rJ
rJ
rJ
rJ
gV
gV
cf
cf
cf
cf
cf
cf
cf
cf
rJ
gV
gV
cf
cf
cf
cf
gV
gV
gV
rJ
rJ
gV
gV
gV
gV
gV
gV
gV
gV
gV
gV
rJ
"}
(5,1,1) = {"
rJ
cf
rJ
rJ
rJ
cf
cf
cf
cf
cf
cf
cf
cf
cf
cf
cf
cf
cf
cf
cf
cf
cf
cf
cf
cf
cf
cf
cf
cf
cf
cf
cf
cf
cf
cf
cf
cf
cf
cf
gV
"}
(6,1,1) = {"
rJ
cf
rJ
rJ
rJ
cf
vS
Yt
Yt
Yt
Yt
Yt
Yt
Yt
Yt
Yt
Yt
Yt
Yt
Yt
Yt
Yt
Yt
Yt
Yt
Yt
Yt
Yt
Yt
Yt
Yt
Yt
Yt
Yt
Yt
Yt
Yt
qa
cf
gV
"}
(7,1,1) = {"
cf
cf
rJ
gV
cf
cf
Ku
rJ
rJ
rJ
rJ
gV
gV
gV
rJ
rJ
rJ
rJ
rJ
rJ
BO
rJ
rJ
rJ
rJ
rJ
rJ
rJ
gV
cf
cf
cf
cf
cf
cf
cf
cf
GU
cf
gV
"}
(8,1,1) = {"
cf
rJ
rJ
gV
gV
cf
Ku
rJ
rJ
gV
gV
gV
rJ
gV
gV
rJ
BO
rJ
rJ
Bk
rJ
rJ
rJ
rJ
qk
rJ
sF
Kh
qk
gV
cf
cf
cf
cf
cf
cf
cf
GU
cf
gV
"}
(9,1,1) = {"
cf
rJ
rJ
rJ
cf
cf
Ku
rJ
cf
cf
cf
rJ
mG
rJ
gV
rJ
rJ
rJ
BO
rJ
rJ
BO
gV
rJ
Kh
rJ
rD
rD
Kh
gV
gV
gV
cf
cf
cf
cf
cf
GU
cf
gV
"}
(10,1,1) = {"
rJ
cf
rJ
rJ
cf
cf
Ku
rJ
cf
cf
rJ
BO
rJ
rJ
rJ
lN
rJ
rJ
rJ
rJ
gV
gV
gV
BO
Kh
rJ
rJ
sF
sF
rJ
rJ
rJ
gV
cf
cf
cf
cf
GU
cf
gV
"}
(11,1,1) = {"
rJ
cf
gV
gV
cf
cf
Ku
cf
cf
cf
uV
rJ
gV
rJ
qk
Kh
Kh
qk
BO
rJ
gV
gV
cf
gV
sF
rJ
rJ
sF
rJ
rJ
qk
Kh
qk
gV
gV
cf
cf
GU
cf
gV
"}
(12,1,1) = {"
rJ
cf
rJ
gV
cf
cf
Ku
cf
cf
BO
rJ
rJ
gV
rJ
Kh
rD
rD
Kh
rJ
rJ
gV
gV
gV
gV
qk
sF
sF
rJ
qk
rJ
er
sF
Kh
gV
cf
cf
cf
GU
cf
gV
"}
(13,1,1) = {"
rJ
cf
rJ
gV
gV
cf
Ku
rJ
cf
rJ
rJ
gV
gV
rJ
Kh
sF
Mi
Kh
rJ
rJ
rJ
gV
gV
gV
gV
JA
JA
JA
Bk
rJ
Kh
OO
Kh
gV
cf
cf
cf
GU
cf
cf
"}
(14,1,1) = {"
rJ
cf
rJ
gV
gV
cf
Ku
rJ
rJ
rJ
gV
gV
gV
rJ
Kh
sF
rD
Kh
BO
rJ
rJ
JA
JA
gV
gV
rJ
rJ
rJ
rJ
JA
qk
Kh
qk
gV
gV
cf
cf
GU
cf
cf
"}
(15,1,1) = {"
rJ
cf
rJ
gV
gV
cf
Ku
rJ
rJ
Bk
gV
gV
ad
Yt
qk
er
Kh
qk
Yt
ta
JA
qk
Kh
Kh
Kh
Kh
Kh
Kh
qk
JA
rJ
gV
gV
cf
cf
cf
cf
GU
cf
cf
"}
(16,1,1) = {"
rJ
rJ
cf
gV
gV
cf
Ku
rJ
gV
gV
gV
rJ
Ku
Yg
rJ
rJ
JA
JA
rJ
rJ
BO
Kh
rD
rD
rD
rD
sF
vl
Kh
rJ
gV
gV
gV
cf
cf
cf
cf
GU
cf
cf
"}
(17,1,1) = {"
rJ
rJ
cf
gV
rJ
KG
gV
De
gV
gV
Wd
BO
Ku
rJ
YY
rJ
JA
Bk
OF
rJ
rJ
Kh
sF
sF
Yi
sF
sF
sF
Kh
rJ
JA
JA
rJ
gV
gV
gV
cf
GU
cf
gV
"}
(18,1,1) = {"
rJ
rJ
rJ
ax
BO
JA
JA
JA
rJ
rJ
JA
JA
JA
rJ
rJ
mC
rJ
rJ
JA
JA
rJ
Kh
sF
sF
sF
sF
sF
LI
Kh
rJ
BO
JA
rJ
rJ
gV
gV
cf
GU
cf
gV
"}
(19,1,1) = {"
rJ
rJ
JA
rJ
JA
JA
JA
JA
ko
JA
rJ
rJ
rJ
JA
JA
JA
rJ
Ep
rJ
JA
JA
er
sF
sF
sF
ci
sF
rD
Kh
BO
gV
gV
JA
rJ
rJ
lN
gV
GU
cf
gV
"}
(20,1,1) = {"
rJ
rJ
BO
gV
gV
hC
ax
gV
gV
Bk
rJ
rJ
rJ
rJ
JA
DJ
rJ
rJ
rJ
JA
wf
Kh
sF
sF
sF
sF
sF
UE
Kh
gV
gV
rJ
rJ
rJ
rJ
rJ
rJ
GU
cf
rJ
"}
(21,1,1) = {"
rJ
rJ
rJ
cf
cf
cf
Ku
gV
gV
rJ
De
rJ
rJ
Ku
JA
JA
JA
rJ
JA
OF
rJ
Kh
sF
sF
Yi
sF
sF
sF
Kh
gV
gV
gV
Ii
gV
JA
mG
rJ
GU
cf
rJ
"}
(22,1,1) = {"
rJ
rJ
rJ
gV
cf
cf
Ku
rJ
rJ
rJ
gV
gV
rJ
Ku
De
gV
JA
JA
rJ
oK
rJ
Kh
rD
rD
rD
rD
ky
DQ
Kh
gV
gV
gV
gV
gV
JA
rJ
rJ
GU
cf
gV
"}
(23,1,1) = {"
rJ
rJ
rJ
rJ
cf
cf
Ku
rJ
rJ
rJ
BO
gV
rJ
Ku
gV
gV
gV
YY
rJ
rJ
Po
qk
Kh
Kh
Kh
Kh
Kh
Kh
qk
gV
Ii
gV
gV
gV
JA
rJ
BO
GU
cf
cf
"}
(24,1,1) = {"
rJ
rJ
rJ
rJ
cf
cf
Ku
rJ
rJ
NP
rJ
gV
rJ
Ku
KG
gV
gV
gV
rJ
BO
gV
gV
gV
rJ
rJ
rJ
Iz
gV
gV
gV
gV
gV
Ii
gV
rJ
BO
BO
GU
cf
cf
"}
(25,1,1) = {"
rJ
rJ
rJ
cf
cf
cf
Ku
rJ
rJ
rJ
rJ
gV
gV
Vm
sB
rJ
gV
gV
rJ
gV
gV
gV
rJ
Bk
rJ
rJ
Iz
gV
gV
gV
gV
Ii
gV
BO
rJ
JA
rJ
GU
cf
cf
"}
(26,1,1) = {"
rJ
rJ
rJ
cf
cf
cf
Ku
rJ
rJ
BO
rJ
gV
gV
rJ
rJ
Ku
gV
gV
gV
gV
gV
gV
qk
Kh
Kh
Kh
qk
gV
gV
Ii
gV
gV
rJ
rJ
rJ
JA
rJ
GU
cf
gV
"}
(27,1,1) = {"
rJ
rJ
rJ
gV
gV
cf
Ku
rJ
mG
rJ
Bk
gV
gV
rJ
rJ
rJ
gV
gV
gV
sB
gV
rJ
Kh
rD
Mi
rD
Kh
rJ
rJ
gV
gV
gV
rJ
rJ
JA
rJ
rJ
GU
cf
gV
"}
(28,1,1) = {"
rJ
rJ
rJ
rJ
gV
cf
Ku
rJ
rJ
cf
cf
gV
gV
gV
rJ
rJ
rJ
rJ
rJ
BO
rJ
rJ
xf
sF
sF
sF
Kh
rJ
rJ
rJ
rJ
BO
rJ
rJ
rJ
BO
rJ
GU
cf
gV
"}
(29,1,1) = {"
rJ
rJ
rJ
rJ
gV
cf
Ku
BO
rJ
rJ
cf
cf
gV
rJ
rJ
mG
rJ
rJ
BO
rJ
Ku
rJ
Kh
rD
fS
rD
Kh
rJ
rJ
mG
rJ
rJ
BO
rJ
rJ
rJ
rJ
GU
cf
gV
"}
(30,1,1) = {"
rJ
cf
rJ
rJ
gV
cf
Ku
rJ
rJ
mG
BO
rJ
gV
gV
uV
rJ
lN
rJ
rJ
rJ
Vm
sB
qk
Kh
Kh
Kh
qk
rJ
rJ
rJ
rJ
BO
rJ
BO
rJ
rJ
rJ
GU
cf
cf
"}
(31,1,1) = {"
rJ
cf
rJ
rJ
cf
cf
Vm
sB
sB
sB
sB
cj
cj
cj
sB
sB
sB
sB
sB
sB
sB
sB
sB
sB
sB
sB
sB
sB
sB
sB
sB
sB
sB
sB
sB
sB
sB
Bs
cf
cf
"}
(32,1,1) = {"
rJ
rJ
cf
rJ
gV
cf
cf
gV
gV
gV
gV
gV
cf
rJ
rJ
cf
cf
cf
gV
gV
gV
cf
cf
cf
cf
rJ
cf
cf
cf
gV
rJ
rJ
gV
gV
cf
cf
cf
cf
cf
cf
"}
(33,1,1) = {"
rJ
rJ
cf
rJ
cf
cf
cf
cf
gV
gV
gV
cf
cf
cf
cf
cf
cf
cf
gV
gV
gV
gV
gV
gV
cf
cf
cf
cf
cf
cf
gV
rJ
cf
cf
cf
cf
cf
cf
cf
cf
"}
(34,1,1) = {"
rJ
rJ
cf
cf
rJ
gV
gV
cf
cf
cf
cf
cf
cf
cf
cf
cf
cf
cf
cf
cf
gV
gV
rJ
rJ
gV
cf
cf
cf
cf
gV
rJ
cf
cf
cf
gV
cf
cf
cf
cf
rJ
"}
(35,1,1) = {"
rJ
rJ
rJ
cf
rJ
rJ
gV
gV
gV
gV
gV
gV
cf
cf
gV
gV
gV
gV
gV
gV
gV
rJ
rJ
rJ
cf
cf
cf
cf
cf
cf
cf
cf
cf
gV
rJ
gV
cf
rJ
rJ
rJ
"}
(36,1,1) = {"
rJ
rJ
rJ
cf
rJ
rJ
rJ
rJ
cf
cf
rJ
gV
gV
gV
gV
gV
rJ
rJ
rJ
rJ
cf
cf
rJ
rJ
rJ
rJ
rJ
gV
gV
gV
gV
gV
rJ
rJ
rJ
gV
gV
rJ
rJ
rJ
"}
(37,1,1) = {"
rJ
rJ
rJ
cf
cf
rJ
rJ
rJ
rJ
cf
cf
rJ
rJ
rJ
rJ
rJ
rJ
rJ
rJ
rJ
cf
cf
cf
rJ
rJ
rJ
rJ
rJ
rJ
rJ
rJ
rJ
rJ
rJ
rJ
rJ
cf
rJ
rJ
rJ
"}
(38,1,1) = {"
rJ
rJ
rJ
rJ
cf
cf
rJ
rJ
rJ
rJ
cf
cf
cf
cf
cf
cf
cf
cf
cf
cf
rJ
rJ
rJ
cf
cf
cf
cf
cf
cf
rJ
rJ
rJ
rJ
rJ
cf
cf
cf
rJ
rJ
rJ
"}
(39,1,1) = {"
rJ
rJ
rJ
rJ
rJ
rJ
cf
cf
cf
rJ
rJ
rJ
cf
cf
rJ
rJ
rJ
rJ
rJ
rJ
rJ
rJ
rJ
rJ
rJ
rJ
rJ
rJ
rJ
cf
cf
cf
cf
cf
rJ
rJ
rJ
rJ
rJ
rJ
"}
(40,1,1) = {"
rJ
rJ
rJ
rJ
rJ
rJ
rJ
rJ
rJ
rJ
rJ
rJ
rJ
rJ
cf
cf
rJ
cf
cf
cf
rJ
rJ
cf
cf
rJ
rJ
rJ
rJ
rJ
rJ
rJ
rJ
rJ
rJ
rJ
rJ
rJ
rJ
rJ
rJ
"}
