//MAP CONVERTED BY dmm2tgm.py THIS HEADER COMMENT PREVENTS RECONVERSION, DO NOT REMOVE
"ad" = (
/obj/item/rogueweapon/huntingknife/villager,
/turf/open/floor/rogue/tile,
/area/rogue/indoors/shelter/town/dwarf)
"ay" = (
/obj/structure/fluff/walldeco/masonflag,
/turf/closed/wall/mineral/rogue/stone,
/area/rogue/outdoors/exposed/decap)
"aH" = (
/turf/open/lava,
/area/rogue/outdoors/exposed/decap)
"bj" = (
/obj/machinery/light/rogue/torchholder{
	dir = 4;
	icon_state = "torchwall1"
	},
/turf/open/floor/rogue/ruinedwood/turned/darker,
/area/rogue/indoors/shelter/town/dwarf)
"bM" = (
/obj/structure/roguetent/preopen,
/turf/open/floor/rogue/dirt/road,
/area/rogue/outdoors/exposed/decap)
"cI" = (
/obj/item/clothing/head/roguetown/helmet/goblin,
/turf/open/floor/rogue/cobblerock,
/area/rogue/outdoors/exposed/decap)
"dx" = (
/turf/closed/wall/mineral/rogue/stonebrick,
/area/rogue/outdoors/exposed/decap)
"dz" = (
/turf/open/floor/rogue/tile/kitchen,
/area/rogue/indoors/shelter/town/dwarf)
"ea" = (
/obj/machinery/light/rogue/firebowl,
/turf/open/floor/rogue/dirt/road,
/area/rogue/outdoors/exposed/decap)
"en" = (
/obj/effect/decal/cleanable/blood/old{
	icon_state = "splatter3"
	},
/turf/open/floor/rogue/ruinedwood/turned,
/area/rogue/outdoors/exposed/decap)
"fl" = (
/turf/closed/mineral/random/rogue/med,
/area/rogue/outdoors/exposed/decap)
"fn" = (
/obj/effect/decal/cleanable/blood/old,
/obj/effect/decal/cleanable/blood/old{
	icon_state = "gib6-old"
	},
/turf/open/floor/rogue/twig,
/area/rogue/outdoors/exposed/decap)
"gw" = (
/obj/machinery/light/rogue/torchholder{
	dir = 8
	},
/turf/open/floor/rogue/dirt/road,
/area/rogue/outdoors/exposed/decap)
"gI" = (
/obj/machinery/light/rogue/torchholder{
	dir = 8
	},
/obj/effect/decal/cleanable/blood/old{
	icon_state = "splatter3"
	},
/turf/open/floor/rogue/ruinedwood/turned/darker,
/area/rogue/indoors/shelter/town/dwarf)
"hu" = (
/turf/closed/mineral/random/rogue,
/area/rogue/outdoors/exposed/decap)
"hA" = (
/obj/item/clothing/head/roguetown/brimmed,
/turf/open/floor/rogue/dirt/road,
/area/rogue/outdoors/exposed/decap)
"jg" = (
/obj/item/ammo_casing/caseless/rogue/arrow/stone,
/turf/open/floor/rogue/ruinedwood/turned/darker,
/area/rogue/indoors/shelter/town/dwarf)
"kn" = (
/obj/effect/decal/cleanable/blood/old,
/obj/effect/decal/cleanable/blood/tracks,
/turf/open/floor/rogue/dirt/road,
/area/rogue/outdoors/exposed/decap)
"ku" = (
/turf/open/floor/rogue/dirt,
/area/rogue/outdoors/exposed/decap)
"lg" = (
/turf/closed/wall/mineral/rogue/stone,
/area/rogue/outdoors/exposed/decap)
"lp" = (
/obj/item/ammo_casing/caseless/rogue/arrow/stone,
/obj/effect/decal/cleanable/blood/old,
/turf/open/floor/rogue/dirt/road,
/area/rogue/outdoors/exposed/decap)
"ma" = (
/turf/open/floor/rogue/cobblerock,
/area/rogue/outdoors/exposed/decap)
"me" = (
/obj/effect/decal/cleanable/blood/old,
/turf/open/floor/rogue/cobblerock,
/area/rogue/outdoors/exposed/decap)
"my" = (
/obj/structure/fluff/walldeco/customflag,
/turf/closed/wall/mineral/rogue/stone,
/area/rogue/outdoors/exposed/decap)
"mX" = (
/turf/closed/wall/mineral/rogue/wood,
/area/rogue/indoors/shelter/town/dwarf)
"nh" = (
/obj/structure/flora/roguetree/burnt,
/turf/open/floor/rogue/dirt/road,
/area/rogue/outdoors/exposed/decap)
"oa" = (
/obj/structure/flora/shroomstump,
/turf/open/floor/rogue/dirt/road,
/area/rogue/outdoors/exposed/decap)
"oz" = (
/obj/structure/flora/rogueshroom,
/turf/open/floor/rogue/dirt,
/area/rogue/outdoors/exposed/decap)
"oF" = (
/obj/effect/decal/cleanable/blood/old,
/obj/item/ammo_casing/caseless/rogue/arrow/stone,
/turf/open/floor/rogue/dirt/road,
/area/rogue/outdoors/exposed/decap)
"ph" = (
/obj/item/rogueweapon/stoneaxe,
/turf/open/floor/rogue/dirt/road,
/area/rogue/outdoors/exposed/decap)
"pB" = (
/turf/open/transparent/openspace,
/area/rogue/indoors/shelter/town/dwarf)
"pO" = (
/obj/structure/roguemachine/mail,
/obj/item/paper/natural,
/obj/item/paper/natural,
/obj/item/paper/natural,
/obj/item/natural/feather,
/turf/open/floor/rogue/tile,
/area/rogue/indoors/shelter/town/dwarf)
"pQ" = (
/obj/item/clothing/head/roguetown/hatfur,
/turf/open/floor/rogue/ruinedwood/turned/darker,
/area/rogue/indoors/shelter/town/dwarf)
"qg" = (
/obj/effect/decal/cleanable/blood/old{
	icon_state = "splatter3"
	},
/obj/structure/stairs{
	dir = 1
	},
/turf/open/floor/rogue/tile,
/area/rogue/indoors/shelter/town/dwarf)
"qJ" = (
/obj/structure/stairs{
	dir = 1
	},
/turf/open/transparent/openspace,
/area/rogue/indoors/shelter/town/dwarf)
"rD" = (
/obj/effect/decal/cleanable/blood/old{
	icon_state = "splatter3"
	},
/turf/open/floor/rogue/ruinedwood/turned/darker,
/area/rogue/indoors/shelter/town/dwarf)
"rS" = (
/obj/structure/bed/rogue/shit,
/turf/open/floor/rogue/ruinedwood/turned/darker,
/area/rogue/indoors/shelter/town/dwarf)
"tC" = (
/obj/structure/handcart,
/turf/open/floor/rogue/ruinedwood/turned,
/area/rogue/outdoors/exposed/decap)
"tN" = (
/obj/item/ammo_casing/caseless/rogue/arrow/stone,
/turf/open/floor/rogue/dirt/road,
/area/rogue/outdoors/exposed/decap)
"uy" = (
/turf/open/transparent/openspace,
/area/rogue/outdoors/exposed/decap)
"ve" = (
/obj/structure/roguewindow/openclose{
	dir = 8
	},
/turf/open/floor/rogue/ruinedwood/turned/darker,
/area/rogue/indoors/shelter/town/dwarf)
"vi" = (
/turf/open/floor/rogue/dirt/road,
/area/rogue/outdoors/exposed/decap)
"vF" = (
/turf/open/floor/rogue/naturalstone,
/area/rogue/outdoors/exposed/decap)
"vJ" = (
/obj/structure/fluff/railing/fence,
/turf/open/floor/rogue/dirt/road,
/area/rogue/outdoors/exposed/decap)
"wf" = (
/obj/effect/decal/cleanable/blood/old,
/obj/item/clothing/head/roguetown/hatfur,
/turf/open/floor/rogue/twig,
/area/rogue/outdoors/exposed/decap)
"wi" = (
/turf/open/floor/rogue/dirt/ambush,
/area/rogue/outdoors/exposed/decap)
"yD" = (
/obj/structure/fluff/railing/fence,
/turf/open/floor/rogue/dirt,
/area/rogue/outdoors/exposed/decap)
"yF" = (
/turf/open/floor/rogue/ruinedwood/turned/darker,
/area/rogue/indoors/shelter/town/dwarf)
"AZ" = (
/obj/item/reagent_containers/glass/cup/wooden/crafted,
/turf/open/floor/rogue/ruinedwood/turned/darker,
/area/rogue/indoors/shelter/town/dwarf)
"Br" = (
/obj/structure/mirror,
/turf/open/floor/rogue/ruinedwood/turned/darker,
/area/rogue/indoors/shelter/town/dwarf)
"BB" = (
/obj/structure/stairs/stone,
/turf/open/floor/rogue/dirt/road,
/area/rogue/outdoors/exposed/decap)
"BN" = (
/obj/effect/decal/cleanable/blood/tracks,
/turf/open/floor/rogue/ruinedwood/turned/darker,
/area/rogue/indoors/shelter/town/dwarf)
"BO" = (
/obj/effect/decal/cleanable/blood/old{
	icon_state = "splatter3"
	},
/turf/open/floor/rogue/tile,
/area/rogue/indoors/shelter/town/dwarf)
"CG" = (
/obj/structure/fluff/walldeco/customflag,
/turf/closed/wall/mineral/rogue/stonebrick,
/area/rogue/indoors/shelter/town/dwarf)
"El" = (
/turf/closed/mineral/random/rogue/high,
/area/rogue/outdoors/exposed/decap)
"Fl" = (
/obj/structure/mineral_door/wood/deadbolt,
/turf/open/floor/rogue/ruinedwood/turned/darker,
/area/rogue/indoors/shelter/town/dwarf)
"Fv" = (
/turf/closed/wall/mineral/rogue/stonebrick,
/area/rogue/indoors/shelter/town/dwarf)
"FB" = (
/obj/structure/roguewindow/openclose{
	dir = 8
	},
/turf/open/floor/rogue/tile,
/area/rogue/indoors/shelter/town/dwarf)
"FW" = (
/obj/machinery/light/rogue/torchholder{
	dir = 4;
	icon_state = "torchwall1"
	},
/obj/structure/closet/crate/chest/neu_fancy,
/obj/item/clothing/suit/roguetown/shirt/tunic/green,
/turf/open/floor/rogue/ruinedwood/turned/darker,
/area/rogue/indoors/shelter/town/dwarf)
"Gj" = (
/obj/structure/fluff/railing/fence{
	dir = 8
	},
/turf/open/floor/rogue/dirt/road,
/area/rogue/outdoors/exposed/decap)
"GK" = (
/obj/structure/stairs/stone,
/turf/open/floor/rogue/dirt/ambush,
/area/rogue/outdoors/exposed/decap)
"GT" = (
/obj/item/reagent_containers/glass/bucket,
/turf/open/floor/rogue/cobblerock,
/area/rogue/outdoors/exposed/decap)
"II" = (
/obj/structure/bed/rogue/shit,
/turf/open/floor/rogue/tile,
/area/rogue/indoors/shelter/town/dwarf)
"IT" = (
/obj/item/rogueweapon/mace/woodclub,
/obj/effect/decal/cleanable/blood/old{
	icon_state = "splatter3"
	},
/turf/open/floor/rogue/twig,
/area/rogue/outdoors/exposed/decap)
"Js" = (
/obj/structure/flora/roguetree/burnt,
/turf/open/floor/rogue/dirt,
/area/rogue/outdoors/exposed/decap)
"Lv" = (
/obj/structure/bed/rogue/shit,
/obj/item/reagent_containers/glass/cup/wooden/crafted,
/turf/open/floor/rogue/tile,
/area/rogue/indoors/shelter/town/dwarf)
"LF" = (
/obj/item/rogueweapon/huntingknife/stoneknife,
/turf/open/floor/rogue/dirt/road,
/area/rogue/outdoors/exposed/decap)
"Mz" = (
/obj/machinery/light/rogue/torchholder,
/turf/closed/wall/mineral/rogue/stonebrick,
/area/rogue/outdoors/exposed/decap)
"Ne" = (
/obj/structure/mineral_door/wood/deadbolt{
	dir = 8
	},
/turf/open/floor/rogue/tile,
/area/rogue/outdoors/exposed/decap)
"Ny" = (
/obj/structure/roguetent/preopen,
/turf/open/floor/rogue/dirt,
/area/rogue/outdoors/exposed/decap)
"NA" = (
/turf/closed/wall/mineral/rogue/tent,
/area/rogue/outdoors/exposed/decap)
"Ob" = (
/obj/item/rogueweapon/pick,
/turf/open/floor/rogue/tile,
/area/rogue/indoors/shelter/town/dwarf)
"Oi" = (
/obj/effect/decal/cleanable/blood/tracks,
/turf/open/floor/rogue/dirt/road,
/area/rogue/outdoors/exposed/decap)
"Px" = (
/obj/structure/well,
/turf/open/floor/rogue/dirt/road,
/area/rogue/outdoors/exposed/decap)
"Qj" = (
/obj/effect/decal/cleanable/blood/splatter,
/turf/open/floor/rogue/ruinedwood/turned/darker,
/area/rogue/indoors/shelter/town/dwarf)
"QC" = (
/obj/structure/roguemachine/scomm,
/turf/open/floor/rogue/ruinedwood/turned/darker,
/area/rogue/indoors/shelter/town/dwarf)
"QW" = (
/obj/effect/decal/cleanable/blood/old,
/turf/open/floor/rogue/dirt,
/area/rogue/outdoors/exposed/decap)
"RF" = (
/obj/effect/decal/cleanable/blood/old,
/turf/open/floor/rogue/dirt/road,
/area/rogue/outdoors/exposed/decap)
"Tp" = (
/obj/item/clothing/head/roguetown/helmet/goblin,
/turf/open/floor/rogue/dirt/road,
/area/rogue/outdoors/exposed/decap)
"Un" = (
/obj/structure/roguewindow/openclose{
	dir = 4
	},
/turf/open/floor/rogue/ruinedwood/turned/darker,
/area/rogue/indoors/shelter/town/dwarf)
"UI" = (
/obj/machinery/light/rogue/torchholder,
/turf/closed/wall/mineral/rogue/stone,
/area/rogue/outdoors/exposed/decap)
"UP" = (
/obj/structure/flora/rogueshroom,
/turf/open/floor/rogue/dirt/road,
/area/rogue/outdoors/exposed/decap)
"Vv" = (
/obj/machinery/light/rogue/torchholder{
	dir = 8
	},
/turf/open/floor/rogue/tile,
/area/rogue/indoors/shelter/town/dwarf)
"Xa" = (
/obj/machinery/light/rogue/hearth,
/turf/open/floor/rogue/tile/kitchen,
/area/rogue/indoors/shelter/town/dwarf)
"Xc" = (
/obj/item/ammo_casing/caseless/rogue/arrow/stone,
/obj/effect/decal/cleanable/blood/old{
	icon_state = "splatter3"
	},
/turf/open/floor/rogue/twig,
/area/rogue/outdoors/exposed/decap)
"Ye" = (
/turf/open/floor/rogue/tile,
/area/rogue/indoors/shelter/town/dwarf)
"ZM" = (
/obj/structure/roguewindow/openclose{
	dir = 1
	},
/turf/open/floor/rogue/ruinedwood/turned/darker,
/area/rogue/indoors/shelter/town/dwarf)

(1,1,1) = {"
fl
fl
fl
fl
fl
fl
fl
fl
fl
fl
fl
fl
fl
fl
fl
fl
fl
fl
fl
fl
fl
fl
fl
fl
fl
fl
El
fl
fl
fl
fl
fl
fl
fl
fl
"}
(2,1,1) = {"
fl
fl
fl
fl
fl
fl
fl
fl
fl
fl
El
fl
El
fl
fl
El
fl
fl
fl
fl
fl
fl
fl
fl
fl
fl
fl
El
fl
El
El
fl
fl
fl
fl
"}
(3,1,1) = {"
fl
fl
fl
fl
fl
fl
El
fl
fl
fl
El
fl
fl
El
fl
fl
El
El
fl
fl
El
El
fl
El
fl
El
fl
fl
fl
fl
fl
El
fl
fl
fl
"}
(4,1,1) = {"
fl
fl
fl
El
fl
fl
fl
fl
fl
fl
fl
fl
fl
fl
fl
fl
fl
fl
fl
fl
fl
fl
fl
fl
fl
fl
fl
fl
fl
fl
fl
fl
El
fl
fl
"}
(5,1,1) = {"
fl
fl
fl
fl
fl
fl
fl
wi
wi
wi
wi
wi
El
El
wi
wi
wi
wi
wi
wi
wi
wi
fl
fl
El
El
wi
wi
wi
wi
fl
fl
El
fl
fl
"}
(6,1,1) = {"
fl
fl
fl
El
El
fl
El
fl
wi
fl
fl
wi
fl
El
wi
wi
fl
El
El
wi
wi
fl
fl
fl
fl
fl
wi
wi
wi
fl
wi
fl
fl
fl
fl
"}
(7,1,1) = {"
fl
fl
El
fl
fl
El
El
fl
fl
fl
wi
wi
wi
fl
fl
El
El
wi
El
El
El
fl
fl
El
fl
fl
fl
wi
wi
fl
fl
wi
fl
fl
fl
"}
(8,1,1) = {"
fl
fl
fl
fl
fl
El
fl
wi
wi
wi
wi
fl
fl
wi
fl
El
El
El
aH
aH
El
fl
fl
fl
fl
El
fl
wi
fl
El
fl
fl
fl
El
fl
"}
(9,1,1) = {"
fl
El
El
fl
fl
fl
wi
fl
El
wi
wi
wi
fl
fl
fl
El
El
El
aH
aH
wi
wi
fl
fl
El
fl
wi
wi
fl
wi
fl
fl
El
fl
fl
"}
(10,1,1) = {"
fl
fl
wi
wi
wi
wi
fl
wi
wi
wi
fl
wi
fl
fl
El
El
aH
El
El
aH
wi
fl
fl
El
wi
wi
wi
wi
El
fl
wi
fl
fl
fl
fl
"}
(11,1,1) = {"
fl
fl
wi
wi
wi
wi
wi
fl
wi
wi
fl
fl
fl
El
fl
wi
aH
aH
El
El
fl
fl
El
fl
wi
fl
wi
El
El
wi
fl
wi
fl
El
fl
"}
(12,1,1) = {"
fl
fl
wi
wi
fl
El
fl
fl
wi
wi
fl
fl
wi
fl
wi
El
aH
aH
El
wi
fl
El
fl
fl
wi
wi
fl
El
fl
fl
wi
wi
fl
fl
fl
"}
(13,1,1) = {"
fl
fl
wi
fl
fl
wi
wi
wi
wi
fl
wi
wi
wi
wi
fl
wi
wi
El
El
wi
fl
fl
wi
wi
wi
wi
wi
wi
wi
fl
wi
wi
fl
El
fl
"}
(14,1,1) = {"
fl
fl
El
fl
wi
wi
wi
wi
wi
fl
fl
El
wi
fl
fl
wi
wi
wi
wi
fl
El
fl
fl
wi
wi
fl
El
fl
fl
wi
wi
wi
fl
fl
fl
"}
(15,1,1) = {"
fl
fl
El
wi
wi
wi
wi
fl
fl
wi
fl
fl
fl
fl
fl
fl
fl
wi
wi
fl
El
El
wi
wi
wi
wi
wi
fl
wi
wi
fl
wi
fl
El
fl
"}
(16,1,1) = {"
fl
fl
El
wi
wi
wi
fl
fl
fl
wi
fl
fl
El
fl
fl
fl
wi
wi
fl
fl
wi
El
wi
wi
wi
wi
fl
wi
fl
wi
fl
wi
fl
El
fl
"}
(17,1,1) = {"
fl
fl
wi
fl
wi
wi
fl
fl
wi
wi
wi
fl
El
fl
wi
fl
fl
fl
fl
wi
El
wi
wi
wi
fl
El
wi
wi
fl
wi
fl
wi
fl
El
fl
"}
(18,1,1) = {"
fl
fl
fl
fl
wi
wi
fl
El
fl
fl
fl
fl
fl
fl
fl
wi
fl
wi
El
El
El
El
fl
wi
wi
fl
fl
El
El
wi
fl
wi
fl
El
fl
"}
(19,1,1) = {"
fl
fl
wi
fl
fl
wi
wi
fl
fl
fl
fl
fl
El
fl
fl
wi
fl
fl
fl
fl
fl
fl
wi
wi
El
wi
fl
wi
El
wi
wi
wi
fl
El
fl
"}
(20,1,1) = {"
fl
fl
fl
fl
wi
El
fl
fl
wi
wi
wi
fl
fl
fl
fl
fl
El
fl
fl
wi
wi
wi
wi
wi
wi
wi
wi
wi
El
El
wi
wi
fl
El
fl
"}
(21,1,1) = {"
fl
El
fl
fl
wi
wi
wi
fl
wi
wi
wi
wi
wi
wi
fl
fl
fl
fl
wi
wi
wi
wi
wi
wi
wi
wi
wi
wi
El
fl
wi
wi
fl
El
fl
"}
(22,1,1) = {"
fl
fl
wi
wi
fl
wi
fl
fl
wi
wi
wi
wi
wi
wi
fl
fl
wi
wi
El
wi
El
fl
fl
wi
El
wi
fl
fl
fl
wi
wi
wi
fl
fl
fl
"}
(23,1,1) = {"
fl
El
wi
wi
fl
wi
El
fl
wi
wi
wi
wi
wi
wi
wi
wi
wi
fl
fl
wi
El
wi
wi
wi
wi
wi
fl
El
fl
wi
wi
wi
fl
El
fl
"}
(24,1,1) = {"
fl
El
wi
wi
El
wi
El
fl
wi
wi
wi
lg
lg
wi
wi
wi
wi
wi
wi
fl
fl
wi
wi
fl
fl
fl
fl
El
fl
wi
wi
wi
fl
El
fl
"}
(25,1,1) = {"
fl
fl
wi
fl
wi
wi
fl
fl
wi
wi
wi
GK
lg
wi
wi
wi
wi
wi
wi
fl
El
El
fl
wi
wi
wi
El
fl
wi
wi
wi
wi
fl
fl
fl
"}
(26,1,1) = {"
fl
fl
wi
fl
fl
wi
fl
fl
wi
wi
wi
GK
lg
wi
wi
wi
wi
wi
wi
fl
El
fl
fl
fl
wi
wi
fl
wi
wi
wi
El
El
fl
fl
fl
"}
(27,1,1) = {"
fl
fl
wi
wi
fl
El
fl
fl
wi
wi
wi
lg
lg
wi
wi
wi
wi
wi
wi
fl
fl
fl
wi
wi
wi
wi
wi
wi
wi
wi
El
wi
fl
El
fl
"}
(28,1,1) = {"
fl
fl
wi
wi
wi
wi
fl
fl
fl
wi
wi
wi
wi
wi
wi
wi
wi
wi
wi
wi
wi
wi
wi
wi
wi
wi
wi
wi
wi
wi
wi
wi
El
El
fl
"}
(29,1,1) = {"
fl
El
fl
fl
fl
fl
fl
fl
fl
fl
fl
fl
fl
fl
fl
fl
El
fl
fl
El
fl
El
fl
fl
fl
fl
fl
El
El
fl
fl
fl
El
fl
fl
"}
(30,1,1) = {"
fl
El
fl
fl
El
El
El
fl
fl
fl
El
fl
fl
fl
fl
fl
fl
fl
fl
fl
fl
fl
fl
fl
fl
fl
fl
fl
fl
fl
El
fl
fl
fl
fl
"}

(1,1,2) = {"
fl
fl
fl
fl
fl
fl
fl
fl
fl
fl
fl
fl
fl
fl
fl
El
El
El
El
El
fl
fl
fl
fl
fl
fl
fl
hu
hu
fl
UP
vi
UP
hu
hu
"}
(2,1,2) = {"
fl
fl
fl
El
El
El
El
fl
fl
fl
fl
fl
El
fl
El
fl
fl
El
fl
fl
fl
fl
fl
fl
fl
fl
hu
hu
UP
vi
vi
vi
vi
ma
vi
"}
(3,1,2) = {"
fl
fl
El
fl
El
fl
El
El
fl
El
fl
El
El
fl
fl
El
fl
fl
fl
vF
vF
vF
fl
fl
fl
NA
NA
UP
vi
vi
vi
ma
ma
ma
ma
"}
(4,1,2) = {"
fl
fl
El
fl
El
El
El
fl
El
fl
El
El
fl
fl
fl
fl
fl
fl
fl
fl
vF
vF
vF
vF
vi
vi
NA
vi
vi
RF
RF
me
ma
ma
ma
"}
(5,1,2) = {"
fl
fl
El
El
fl
El
fl
El
fl
El
fl
fl
fl
fl
vi
vi
vi
vi
vi
NA
vi
vi
vi
vi
vi
vi
NA
vi
ma
vi
vi
vi
vi
vi
vi
"}
(6,1,2) = {"
fl
fl
El
El
fl
El
El
El
fl
fl
fl
fl
fl
ku
vi
vi
vi
vi
vi
NA
NA
NA
vi
vi
vi
bM
lp
vi
vi
vi
vi
vi
vi
vi
vi
"}
(7,1,2) = {"
fl
fl
El
El
fl
El
fl
fl
fl
fl
fl
fl
fl
ku
vi
vi
vi
vi
vi
vi
vi
NA
NA
NA
bM
RF
ma
RF
vi
vi
vi
vi
vi
vi
vi
"}
(8,1,2) = {"
fl
fl
El
El
fl
fl
fl
fl
fl
fl
fl
fl
oz
ku
vi
vi
vi
vi
UP
vi
vi
vi
vi
vi
vi
vi
ma
me
ma
vi
vi
vi
vi
vi
vi
"}
(9,1,2) = {"
fl
El
El
fl
fl
fl
fl
fl
fl
fl
ku
fl
ku
ku
vi
vi
vi
vi
vi
vi
vi
nh
vi
vi
vi
me
me
ma
vi
vi
vi
vi
vi
vi
vi
"}
(10,1,2) = {"
fl
fl
fl
fl
fl
fl
fl
ku
ku
ku
ku
ku
ku
vi
vi
UP
vi
nh
vi
vi
vi
vi
vi
ma
ma
ma
ma
vi
vi
vi
vi
vi
vi
vi
vi
"}
(11,1,2) = {"
fl
El
fl
fl
fl
fl
ku
ku
ku
ku
ku
ku
ku
vi
vi
vi
vi
vi
vi
vi
vi
vi
UP
ma
ma
vi
vi
vi
vi
vi
vi
vi
vi
vi
vi
"}
(12,1,2) = {"
fl
El
fl
fl
fl
fl
ku
ku
ku
ku
ku
ku
ku
vi
vi
vi
ku
ku
ku
ku
vi
ma
ma
ma
ma
vi
ma
ma
vi
vi
vi
vi
vi
vi
vi
"}
(13,1,2) = {"
fl
fl
El
fl
fl
fl
ku
ku
ku
ku
ku
ku
ku
vi
vi
vi
vi
vi
vi
ma
ma
ma
ma
ma
vi
vi
vi
vi
ma
vi
vi
ku
vi
vi
vi
"}
(14,1,2) = {"
fl
El
El
fl
fl
ku
ku
dx
dx
ku
ku
ku
ku
vi
vi
vi
vi
vi
vi
ma
ma
ma
ma
vi
ma
ma
ma
vi
vi
vi
ku
ku
ku
Oi
Oi
"}
(15,1,2) = {"
fl
fl
El
fl
ku
dx
dx
Lv
II
dx
dx
dx
dx
dx
dx
Gj
Gj
Gj
my
ma
ma
ma
vi
vi
vi
ma
vi
vi
vi
ku
ku
ku
ku
QW
vJ
"}
(16,1,2) = {"
fl
El
El
fl
dx
Ye
II
Ye
BO
Fv
QC
bj
jg
yF
ZM
vi
vi
hA
ma
ma
ma
ma
vi
ma
ma
vi
vi
vi
vi
ku
ku
ku
ku
ku
vJ
"}
(17,1,2) = {"
fl
El
fl
fl
Mz
Ye
Ye
BO
ad
yF
Ye
pQ
Ye
Ye
Fv
ph
vi
ma
ma
ma
vi
vi
ay
tN
vi
vi
vi
vi
vi
ku
ku
ku
ku
ku
vJ
"}
(18,1,2) = {"
ku
fl
fl
fl
dx
mX
qg
BO
Fv
pO
Ye
rD
Ob
yF
BO
vi
vi
vi
vi
ma
me
vi
lg
lg
vi
vi
vi
UP
ku
ku
ku
ku
ku
hu
hu
"}
(19,1,2) = {"
ku
fl
fl
fl
dx
Fv
Fv
Fv
Fv
Fv
yF
Vv
yF
rD
Fv
vi
tN
vi
vi
vi
ma
me
RF
lg
vi
vi
vi
ku
ku
ku
ku
ku
oz
hu
hu
"}
(20,1,2) = {"
ku
fl
fl
fl
fl
fl
fl
fl
fl
fl
Fv
Fv
FB
Ne
CG
vi
vi
vi
ea
tN
RF
cI
kn
kn
Oi
vi
ku
Js
ku
ku
ku
ku
ku
ku
hu
"}
(21,1,2) = {"
ku
fl
El
fl
fl
fl
fl
fl
fl
fl
vi
vi
tN
vi
LF
ma
ma
GT
vi
vi
vi
ma
vi
vJ
oF
vi
vi
ku
ku
ku
ku
Js
ku
ku
hu
"}
(22,1,2) = {"
ku
fl
El
fl
fl
fl
fl
fl
fl
fl
vi
vi
vi
vi
Tp
ma
Px
ma
vi
vi
vi
ma
ma
vi
vi
vi
ku
ku
ku
ku
ku
ku
ku
ku
hu
"}
(23,1,2) = {"
ku
El
fl
El
El
fl
fl
fl
fl
fl
vi
vi
vi
vi
vi
ma
ma
ma
vi
oa
vi
vi
ma
vJ
vi
vi
ku
ku
ku
ku
ku
ku
oz
ku
hu
"}
(24,1,2) = {"
ku
fl
El
El
fl
El
El
fl
fl
fl
lg
UI
vi
vi
vi
vi
gw
vi
vi
vi
vi
ma
ma
ku
ku
ku
ku
ku
oz
ku
ku
ku
ku
ku
hu
"}
(25,1,2) = {"
ku
El
El
El
fl
El
fl
El
fl
fl
lg
uy
BB
vi
vi
NA
NA
Ny
NA
vi
vi
ma
vi
yD
ku
ku
ku
ku
ku
ku
ku
ku
ku
ku
ku
"}
(26,1,2) = {"
ku
fl
El
El
fl
fl
El
El
El
fl
lg
uy
BB
vi
vi
NA
en
wf
NA
vi
vi
ma
vi
yD
ku
ku
ku
ku
ku
ku
ku
ku
ku
ku
ku
"}
(27,1,2) = {"
ku
ku
fl
El
fl
El
fl
fl
fl
fl
lg
lg
vi
vi
vi
NA
IT
fn
NA
vi
vi
ma
ku
ku
ku
ku
ku
ku
ku
oz
ku
ku
ku
ku
ku
"}
(28,1,2) = {"
ku
ku
fl
El
El
fl
El
El
fl
El
fl
fl
lg
lg
lg
NA
tC
Xc
NA
vi
ma
ma
ku
yD
ku
oz
ku
ku
ku
ku
ku
ku
ku
ku
ku
"}
(29,1,2) = {"
ku
ku
ku
fl
fl
El
El
El
El
fl
fl
El
fl
fl
fl
NA
NA
NA
NA
vi
ma
ku
ku
yD
ku
ku
ku
ku
ku
ku
ku
ku
ku
ku
ku
"}
(30,1,2) = {"
ku
ku
ku
hu
hu
hu
hu
hu
hu
hu
hu
hu
hu
hu
hu
hu
hu
hu
hu
hu
hu
hu
hu
hu
hu
hu
ku
ku
ku
ku
ku
ku
ku
ku
ku
"}

(1,1,3) = {"
uy
uy
uy
uy
uy
uy
uy
uy
uy
uy
uy
uy
uy
uy
uy
uy
uy
uy
uy
uy
uy
uy
uy
uy
uy
uy
uy
uy
uy
uy
uy
uy
uy
uy
uy
"}
(2,1,3) = {"
uy
uy
uy
uy
uy
uy
uy
uy
uy
uy
uy
uy
uy
uy
uy
uy
uy
uy
uy
uy
uy
uy
uy
uy
uy
uy
uy
uy
uy
uy
uy
uy
uy
uy
uy
"}
(3,1,3) = {"
uy
uy
uy
uy
uy
uy
uy
uy
uy
uy
uy
uy
uy
uy
uy
uy
uy
uy
uy
uy
uy
uy
uy
uy
uy
uy
uy
uy
uy
uy
uy
uy
uy
uy
uy
"}
(4,1,3) = {"
uy
uy
uy
uy
uy
uy
uy
uy
uy
uy
uy
uy
uy
uy
uy
uy
uy
uy
uy
uy
uy
uy
uy
uy
uy
uy
uy
uy
uy
uy
uy
uy
uy
uy
uy
"}
(5,1,3) = {"
uy
uy
uy
uy
uy
uy
uy
uy
uy
uy
uy
uy
uy
uy
uy
uy
uy
uy
uy
uy
uy
uy
uy
uy
uy
uy
uy
uy
uy
uy
uy
uy
uy
uy
uy
"}
(6,1,3) = {"
uy
uy
uy
uy
uy
uy
uy
uy
uy
uy
uy
uy
uy
uy
uy
uy
uy
uy
uy
uy
uy
uy
uy
uy
uy
uy
uy
uy
uy
uy
uy
uy
uy
uy
uy
"}
(7,1,3) = {"
uy
uy
uy
uy
uy
uy
uy
uy
uy
uy
uy
uy
uy
uy
uy
uy
uy
uy
uy
uy
uy
uy
uy
uy
uy
uy
uy
uy
uy
uy
uy
uy
uy
uy
uy
"}
(8,1,3) = {"
uy
uy
uy
uy
uy
uy
uy
uy
uy
uy
uy
uy
uy
uy
uy
uy
uy
uy
uy
uy
uy
uy
uy
uy
uy
uy
uy
uy
uy
uy
uy
uy
uy
uy
uy
"}
(9,1,3) = {"
uy
uy
uy
uy
uy
uy
uy
uy
uy
uy
uy
uy
uy
uy
uy
uy
uy
uy
uy
uy
uy
uy
uy
uy
uy
uy
uy
uy
uy
uy
uy
uy
uy
uy
uy
"}
(10,1,3) = {"
uy
uy
uy
uy
uy
uy
uy
uy
uy
uy
uy
uy
uy
uy
uy
uy
uy
uy
uy
uy
uy
uy
uy
uy
uy
uy
uy
uy
uy
uy
uy
uy
uy
uy
uy
"}
(11,1,3) = {"
uy
uy
uy
uy
uy
uy
uy
uy
uy
uy
uy
uy
uy
uy
uy
uy
uy
uy
uy
uy
uy
uy
uy
uy
uy
uy
uy
uy
uy
uy
uy
uy
uy
uy
uy
"}
(12,1,3) = {"
uy
uy
uy
uy
uy
uy
uy
uy
uy
uy
uy
uy
uy
uy
uy
uy
uy
uy
uy
uy
uy
uy
uy
uy
uy
uy
uy
uy
uy
uy
uy
uy
uy
uy
uy
"}
(13,1,3) = {"
uy
uy
uy
uy
uy
uy
uy
uy
uy
uy
uy
uy
uy
uy
uy
uy
uy
uy
uy
uy
uy
uy
uy
uy
uy
uy
uy
uy
uy
uy
uy
uy
uy
uy
uy
"}
(14,1,3) = {"
uy
uy
uy
uy
uy
uy
uy
Fv
Fv
uy
uy
uy
uy
uy
uy
uy
uy
uy
uy
uy
uy
uy
uy
uy
uy
uy
uy
uy
uy
uy
uy
uy
uy
uy
uy
"}
(15,1,3) = {"
uy
uy
uy
uy
uy
Fv
Fv
Xa
dz
Fv
Un
Fv
Fv
Fv
Fv
uy
uy
uy
uy
uy
uy
uy
uy
uy
uy
uy
uy
uy
uy
uy
uy
uy
uy
uy
uy
"}
(16,1,3) = {"
uy
uy
uy
uy
Fv
yF
rD
rD
AZ
yF
yF
Fv
Br
FW
Fv
uy
uy
uy
uy
uy
uy
uy
uy
uy
uy
uy
uy
uy
uy
uy
uy
uy
uy
uy
uy
"}
(17,1,3) = {"
uy
uy
uy
uy
Fv
yF
yF
rD
BN
BN
BN
Fv
yF
yF
ZM
uy
uy
uy
uy
uy
uy
uy
uy
uy
uy
uy
uy
uy
uy
uy
uy
uy
uy
uy
uy
"}
(18,1,3) = {"
uy
uy
uy
uy
Fv
qJ
pB
AZ
gI
yF
Qj
Fl
yF
Qj
Fv
uy
uy
uy
uy
uy
uy
uy
uy
uy
uy
uy
uy
uy
uy
uy
uy
uy
uy
uy
uy
"}
(19,1,3) = {"
uy
uy
uy
uy
Fv
Fv
Fv
Fv
Fv
Fv
yF
Fv
Qj
rS
Fv
uy
uy
uy
uy
uy
uy
uy
uy
uy
uy
uy
uy
uy
uy
uy
uy
uy
uy
uy
uy
"}
(20,1,3) = {"
uy
uy
uy
uy
uy
uy
uy
uy
uy
uy
ve
Fv
Fv
Fv
Fv
uy
uy
uy
uy
uy
uy
uy
uy
uy
uy
uy
uy
uy
uy
uy
uy
uy
uy
uy
uy
"}
(21,1,3) = {"
uy
uy
uy
uy
uy
uy
uy
uy
uy
uy
uy
uy
uy
uy
uy
uy
uy
uy
uy
uy
uy
uy
uy
uy
uy
uy
uy
uy
uy
uy
uy
uy
uy
uy
uy
"}
(22,1,3) = {"
uy
uy
uy
uy
uy
uy
uy
uy
uy
uy
uy
uy
uy
uy
uy
uy
uy
uy
uy
uy
uy
uy
uy
uy
uy
uy
uy
uy
uy
uy
uy
uy
uy
uy
uy
"}
(23,1,3) = {"
uy
uy
uy
uy
uy
uy
uy
uy
uy
uy
uy
uy
uy
uy
uy
uy
uy
uy
uy
uy
uy
uy
uy
uy
uy
uy
uy
uy
uy
uy
uy
uy
uy
uy
uy
"}
(24,1,3) = {"
uy
uy
uy
uy
uy
uy
uy
uy
uy
uy
uy
uy
uy
uy
uy
uy
uy
uy
uy
uy
uy
uy
uy
uy
uy
uy
uy
uy
uy
uy
uy
uy
uy
uy
uy
"}
(25,1,3) = {"
uy
uy
uy
uy
uy
uy
uy
uy
uy
uy
uy
uy
uy
uy
uy
uy
uy
uy
uy
uy
uy
uy
uy
uy
uy
uy
uy
uy
uy
uy
uy
uy
uy
uy
uy
"}
(26,1,3) = {"
uy
uy
uy
uy
uy
uy
uy
uy
uy
uy
uy
uy
uy
uy
uy
uy
uy
uy
uy
uy
uy
uy
uy
uy
uy
uy
uy
uy
uy
uy
uy
uy
uy
uy
uy
"}
(27,1,3) = {"
uy
uy
uy
uy
uy
uy
uy
uy
uy
uy
uy
uy
uy
uy
uy
uy
uy
uy
uy
uy
uy
uy
uy
uy
uy
uy
uy
uy
uy
uy
uy
uy
uy
uy
uy
"}
(28,1,3) = {"
uy
uy
uy
uy
uy
uy
uy
uy
uy
uy
uy
uy
uy
uy
uy
uy
uy
uy
uy
uy
uy
uy
uy
uy
uy
uy
uy
uy
uy
uy
uy
uy
uy
uy
uy
"}
(29,1,3) = {"
uy
uy
uy
uy
uy
uy
uy
uy
uy
uy
uy
uy
uy
uy
uy
uy
uy
uy
uy
uy
uy
uy
uy
uy
uy
uy
uy
uy
uy
uy
uy
uy
uy
uy
uy
"}
(30,1,3) = {"
uy
uy
uy
uy
uy
uy
uy
uy
uy
uy
uy
uy
uy
uy
uy
uy
uy
uy
uy
uy
uy
uy
uy
uy
uy
uy
uy
uy
uy
uy
uy
uy
uy
uy
uy
"}
