//MAP CONVERTED BY dmm2tgm.py THIS HEADER COMMENT PREVENTS RECONVERSION, DO NOT REMOVE
"aL" = (
/obj/machinery/light/rogue/torchholder{
	dir = 4;
	icon_state = "torchwall1"
	},
/obj/structure/table/wood/plain,
/obj/item/reagent_containers/glass/cup/wooden/crafted,
/turf/open/floor/rogue/ruinedwood/turned/darker,
/area/rogue/indoors/town/dwarfin)
"aX" = (
/obj/item/rogueweapon/huntingknife/stoneknife,
/turf/open/floor/rogue/ruinedwood/turned/darker,
/area/rogue/indoors/town/dwarfin)
"bq" = (
/obj/machinery/light/rogue/firebowl,
/turf/open/floor/rogue/dirt,
/area/rogue/outdoors/caves)
"bz" = (
/obj/item/clothing/head/roguetown/brimmed,
/turf/open/floor/rogue/ruinedwood/turned/darker,
/area/rogue/indoors/town/dwarfin)
"cn" = (
/obj/item/ammo_casing/caseless/rogue/dart,
/turf/open/floor/rogue/dirt/road,
/area/rogue/outdoors/caves)
"cE" = (
/turf/open/floor/rogue/cobblerock,
/area/rogue/indoors/town/dwarfin)
"dM" = (
/obj/effect/decal/cleanable/blood/old,
/turf/open/floor/rogue/ruinedwood/turned/darker,
/area/rogue/indoors/town/dwarfin)
"eE" = (
/obj/item/rogueweapon/huntingknife/villager,
/obj/effect/decal/cleanable/blood/old,
/turf/open/floor/rogue/ruinedwood/turned/darker,
/area/rogue/indoors/town/dwarfin)
"fD" = (
/turf/closed/wall/mineral/rogue/wood,
/area/rogue/indoors/town/dwarfin)
"gI" = (
/obj/structure/fluff/railing/fence{
	dir = 8
	},
/turf/open/floor/rogue/dirt/road,
/area/rogue/indoors/town/dwarfin)
"hE" = (
/obj/structure/barricade/wooden/rogue/crude,
/turf/open/floor/rogue/dirt/road,
/area/rogue/outdoors/caves)
"hM" = (
/obj/item/grown/log/tree/small,
/turf/open/floor/rogue/dirt/road,
/area/rogue/outdoors/caves)
"kk" = (
/turf/open/floor/rogue/ruinedwood/turned/darker,
/area/rogue/indoors/town/dwarfin)
"mJ" = (
/turf/closed/wall/mineral/rogue/stone,
/area/rogue/indoors/town/dwarfin)
"mU" = (
/obj/item/restraints/legcuffs/beartrap/armed/camouflage,
/turf/open/floor/rogue/dirt/road,
/area/rogue/outdoors/caves)
"nm" = (
/turf/closed/wall/mineral/rogue/wood,
/area/rogue/outdoors/caves)
"nz" = (
/obj/structure/flora/roguetree/burnt,
/turf/open/floor/rogue/dirt,
/area/rogue/outdoors/caves)
"nK" = (
/obj/item/clothing/head/roguetown/hatfur,
/obj/effect/decal/cleanable/blood/old{
	icon_state = "gib6-old"
	},
/turf/open/floor/rogue/ruinedwood/turned/darker,
/area/rogue/indoors/town/dwarfin)
"qe" = (
/turf/open/floor/rogue/dirt,
/area/rogue/outdoors/caves)
"rl" = (
/turf/closed/mineral/random/rogue/high,
/area/rogue/outdoors/caves)
"sk" = (
/obj/item/ammo_casing/caseless/rogue/arrow/stone,
/turf/open/floor/rogue/ruinedwood/turned/darker,
/area/rogue/indoors/town/dwarfin)
"xJ" = (
/obj/structure/barricade/wooden/rogue/crude,
/turf/closed/wall/mineral/rogue/wood/window,
/area/rogue/outdoors/caves)
"zR" = (
/obj/structure/well,
/turf/open/floor/rogue/dirt/road,
/area/rogue/indoors/town/dwarfin)
"Ar" = (
/turf/closed/wall/mineral/rogue/stone,
/area/rogue/outdoors/caves)
"Br" = (
/obj/structure/fluff/railing/fence{
	dir = 8
	},
/obj/structure/fluff/railing/fence,
/obj/structure/fluff/railing/stonehedge,
/turf/closed/wall/mineral/rogue/stone,
/area/rogue/indoors/town/dwarfin)
"Cl" = (
/obj/machinery/light/rogue/torchholder,
/turf/closed/wall/mineral/rogue/stonebrick,
/area/rogue/outdoors/caves)
"CM" = (
/turf/open/floor/rogue/ruinedwood/turned/darker,
/area/rogue/outdoors/caves)
"De" = (
/obj/structure/roguemachine/mail,
/turf/open/floor/rogue/ruinedwood/turned/darker,
/area/rogue/indoors/town/dwarfin)
"Em" = (
/turf/open/floor/rogue/grass,
/area/rogue/outdoors/caves)
"Et" = (
/obj/structure/barricade/wooden/rogue/crude,
/turf/open/floor/rogue/dirt/road,
/area/rogue/indoors/town/dwarfin)
"EU" = (
/obj/item/ammo_casing/caseless/rogue/dart,
/turf/open/floor/rogue/ruinedwood/turned/darker,
/area/rogue/indoors/town/dwarfin)
"Fe" = (
/obj/item/ammo_casing/caseless/rogue/arrow/stone,
/turf/open/floor/rogue/dirt,
/area/rogue/outdoors/caves)
"Fk" = (
/obj/item/grown/log/tree/small,
/obj/item/grown/log/tree/small,
/turf/open/floor/rogue/dirt/road,
/area/rogue/outdoors/caves)
"FF" = (
/obj/structure/roguemachine/scomm,
/obj/effect/decal/cleanable/blood/old{
	icon_state = "splatter3"
	},
/turf/open/floor/rogue/ruinedwood/turned/darker,
/area/rogue/indoors/town/dwarfin)
"FJ" = (
/obj/structure/flora/roguetree,
/turf/open/floor/rogue/dirt,
/area/rogue/outdoors/caves)
"Gr" = (
/obj/item/ammo_casing/caseless/rogue/arrow/stone,
/turf/open/floor/rogue/dirt/road,
/area/rogue/indoors/town/dwarfin)
"Hs" = (
/obj/structure/flora/roguetree,
/turf/open/floor/rogue/dirt/road,
/area/rogue/outdoors/caves)
"HB" = (
/turf/open/floor/rogue/dirt/road,
/area/rogue/outdoors/caves)
"HL" = (
/obj/machinery/light/rogue/torchholder,
/turf/closed/wall/mineral/rogue/stonebrick,
/area/rogue/indoors/town/dwarfin)
"HO" = (
/turf/closed/wall/mineral/rogue/stonebrick,
/area/rogue/indoors/town/dwarfin)
"IK" = (
/obj/effect/decal/cleanable/blood/old{
	icon_state = "splatter3"
	},
/turf/open/floor/rogue/tile,
/area/rogue/indoors/town/dwarfin)
"JD" = (
/turf/open/floor/rogue/dirt/road,
/area/rogue/indoors/town/dwarfin)
"Kh" = (
/obj/item/reagent_containers/glass/cup/wooden/crafted,
/obj/structure/table/wood/plain,
/turf/open/floor/rogue/tile,
/area/rogue/indoors/town/dwarfin)
"LP" = (
/obj/effect/decal/cleanable/blood/old{
	icon_state = "splatter3"
	},
/turf/open/floor/rogue/ruinedwood/turned/darker,
/area/rogue/indoors/town/dwarfin)
"Mx" = (
/obj/structure/handcart,
/turf/open/floor/rogue/dirt/road,
/area/rogue/indoors/town/dwarfin)
"Nx" = (
/obj/structure/fluff/railing/fence{
	dir = 4
	},
/turf/open/floor/rogue/dirt/road,
/area/rogue/indoors/town/dwarfin)
"Oa" = (
/obj/structure/fluff/railing/fence{
	dir = 4
	},
/turf/open/floor/rogue/cobblerock,
/area/rogue/indoors/town/dwarfin)
"OB" = (
/obj/structure/flora/roguetree/burnt,
/turf/open/floor/rogue/dirt/road,
/area/rogue/outdoors/caves)
"OH" = (
/turf/closed/mineral/random/rogue/med,
/area/rogue/outdoors/caves)
"PQ" = (
/obj/item/reagent_containers/glass/bucket,
/turf/open/floor/rogue/cobblerock,
/area/rogue/indoors/town/dwarfin)
"Qg" = (
/obj/machinery/light/rogue/firebowl,
/turf/open/floor/rogue/dirt/road,
/area/rogue/outdoors/caves)
"Rv" = (
/turf/open/floor/rogue/tile,
/area/rogue/indoors/town/dwarfin)
"Tk" = (
/obj/item/rogueweapon/pick,
/turf/open/floor/rogue/tile,
/area/rogue/indoors/town/dwarfin)
"VU" = (
/obj/structure/table/wood/treestump,
/turf/open/floor/rogue/dirt/road,
/area/rogue/outdoors/caves)
"VX" = (
/obj/structure/barricade/wooden/rogue,
/turf/open/floor/rogue/dirt/road,
/area/rogue/indoors/town/dwarfin)
"Wh" = (
/turf/open/floor/rogue/cobblerock,
/area/rogue/outdoors/caves)
"Xf" = (
/obj/structure/bars,
/turf/open/floor/rogue/dirt,
/area/rogue/outdoors/caves)
"Xp" = (
/obj/structure/bed/rogue/sleepingbag,
/turf/open/floor/rogue/ruinedwood/turned/darker,
/area/rogue/indoors/town/dwarfin)
"Xs" = (
/obj/machinery/light/rogue/torchholder{
	dir = 4;
	icon_state = "torchwall1"
	},
/turf/open/floor/rogue/dirt/road,
/area/rogue/indoors/town/dwarfin)
"Xt" = (
/obj/item/rogueweapon/mace/woodclub,
/turf/open/floor/rogue/ruinedwood/turned/darker,
/area/rogue/indoors/town/dwarfin)
"Yf" = (
/obj/item/ammo_casing/caseless/rogue/arrow/stone,
/turf/open/floor/rogue/dirt/road,
/area/rogue/outdoors/caves)
"Yv" = (
/turf/closed/wall/mineral/rogue/stonebrick,
/area/rogue/outdoors/caves)
"YI" = (
/obj/item/paper/natural,
/obj/item/paper/natural,
/obj/item/paper/natural,
/obj/item/natural/feather,
/obj/structure/table/wood/plain,
/turf/open/floor/rogue/tile,
/area/rogue/indoors/town/dwarfin)
"Za" = (
/obj/item/restraints/legcuffs/beartrap/armed/camouflage,
/turf/open/floor/rogue/dirt,
/area/rogue/outdoors/caves)
"Zm" = (
/obj/item/ammo_casing/caseless/rogue/arrow/stone,
/turf/open/floor/rogue/cobblerock,
/area/rogue/outdoors/caves)
"ZK" = (
/obj/item/ammo_casing/caseless/rogue/dart,
/turf/open/floor/rogue/dirt/road,
/area/rogue/indoors/town/dwarfin)

(1,1,1) = {"
qe
qe
qe
qe
qe
qe
qe
qe
qe
qe
HB
HB
HB
OH
OH
OH
rl
OH
OH
OH
HB
HB
HB
HB
HB
qe
Wh
Wh
Wh
Wh
Wh
Wh
qe
qe
qe
"}
(2,1,1) = {"
qe
qe
qe
qe
qe
nz
qe
qe
qe
qe
HB
HB
OH
OH
rl
rl
rl
OH
OH
OH
HB
HB
HB
OB
HB
Wh
Wh
qe
Wh
Wh
qe
qe
qe
qe
qe
"}
(3,1,1) = {"
qe
qe
qe
nz
qe
qe
qe
qe
qe
nz
HB
OH
OH
OH
rl
rl
OH
OH
OH
nm
HB
HB
HB
HB
Wh
qe
Wh
Wh
Wh
Wh
qe
qe
qe
qe
qe
"}
(4,1,1) = {"
qe
qe
OH
qe
qe
qe
qe
qe
qe
Za
Em
OH
OH
rl
rl
OH
OH
HB
HB
nm
HB
mU
HB
HB
Wh
qe
Wh
Wh
qe
qe
qe
qe
nz
qe
qe
"}
(5,1,1) = {"
qe
qe
OH
qe
qe
nz
qe
qe
qe
qe
Em
OH
rl
rl
OH
OH
HB
HB
HB
nm
HB
HB
Wh
Wh
HB
Wh
Wh
Wh
OH
qe
qe
qe
qe
qe
qe
"}
(6,1,1) = {"
qe
qe
OH
OH
qe
Za
qe
qe
qe
Em
OH
OH
OH
OH
OH
OH
Qg
HB
Hs
nm
HB
Wh
Wh
HB
Wh
Wh
qe
qe
OH
OH
qe
qe
qe
Em
qe
"}
(7,1,1) = {"
nz
qe
OH
OH
OH
qe
qe
qe
nz
qe
OH
OH
OH
OH
OH
Fk
hM
HB
HB
xJ
Zm
Wh
HB
Wh
Wh
qe
qe
Em
Em
OH
Em
qe
qe
OH
OH
"}
(8,1,1) = {"
qe
OH
rl
rl
OH
qe
qe
qe
qe
qe
OH
OH
OH
OH
OH
hM
VU
HB
HB
nm
HB
HB
Wh
Wh
HB
qe
qe
Em
qe
OH
OH
qe
Em
OH
rl
"}
(9,1,1) = {"
qe
OH
rl
rl
OH
OH
qe
qe
Za
qe
xJ
HB
HB
HB
HB
HB
HB
Wh
HB
Wh
Wh
HB
Wh
HB
HB
qe
Em
nz
qe
OH
OH
Em
OH
OH
OH
"}
(10,1,1) = {"
OH
rl
rl
rl
rl
OH
OH
Em
qe
qe
hE
HB
HB
HB
HB
Wh
HB
Wh
Wh
Wh
Wh
Wh
HB
HB
HB
qe
Em
qe
qe
OH
OH
Em
OH
OH
OH
"}
(11,1,1) = {"
OH
rl
rl
OH
rl
rl
OH
OH
qe
xJ
nm
HB
HB
HB
HB
HB
HB
HB
HB
Wh
Yf
HB
HB
HB
HB
qe
Em
qe
qe
OH
OH
OH
OH
rl
OH
"}
(12,1,1) = {"
OH
rl
OH
OH
OH
rl
rl
OH
OH
qe
HB
HB
Yv
HB
HB
HB
HB
HB
HB
Yv
HB
Qg
HB
HB
Em
Em
qe
qe
qe
qe
OH
OH
OH
rl
OH
"}
(13,1,1) = {"
qe
qe
qe
OH
OH
OH
OH
rl
OH
FJ
HB
HB
Cl
HB
HB
CM
HB
Yf
cn
Yv
HB
HB
HB
HB
Em
Em
qe
qe
OH
OH
OH
rl
OH
rl
OH
"}
(14,1,1) = {"
qe
qe
qe
qe
qe
qe
OH
OH
OH
qe
HB
HO
mJ
Gr
kk
LP
kk
mJ
HO
HO
gI
gI
gI
mJ
Br
qe
qe
OH
OH
OH
rl
OH
rl
OH
rl
"}
(15,1,1) = {"
qe
Za
qe
qe
qe
qe
qe
Ar
Ar
qe
HB
HO
FF
Rv
LP
kk
sk
aL
HO
JD
JD
JD
JD
JD
fD
Fe
qe
OH
OH
OH
OH
rl
OH
OH
OH
"}
(16,1,1) = {"
qe
qe
qe
qe
qe
nz
qe
Ar
qe
qe
HB
HO
De
Rv
Rv
EU
IK
Kh
HO
ZK
JD
JD
JD
JD
Et
qe
qe
qe
OH
OH
OH
rl
OH
rl
OH
"}
(17,1,1) = {"
qe
qe
qe
qe
qe
qe
qe
Xf
qe
qe
HB
HO
YI
Xt
Rv
LP
Tk
nK
Et
JD
cE
cE
PQ
JD
fD
qe
qe
FJ
OH
OH
OH
OH
OH
OH
OH
"}
(18,1,1) = {"
qe
qe
nz
qe
qe
qe
qe
Xf
qe
bq
HB
HL
bz
LP
aX
Rv
Rv
eE
Et
Gr
cE
zR
cE
JD
fD
qe
qe
qe
qe
qe
Em
OH
rl
OH
rl
"}
(19,1,1) = {"
qe
qe
Za
qe
qe
qe
qe
Ar
qe
qe
HB
mJ
dM
LP
kk
Rv
Xp
Xp
HO
Mx
cE
cE
cE
JD
Et
qe
qe
qe
qe
qe
qe
Em
OH
OH
rl
"}
(20,1,1) = {"
qe
qe
qe
qe
qe
qe
qe
Ar
qe
qe
HB
HO
HO
kk
kk
kk
mJ
HO
HO
JD
JD
JD
JD
JD
fD
qe
qe
qe
qe
qe
qe
qe
Em
Em
Em
"}
(21,1,1) = {"
qe
qe
qe
nz
qe
qe
qe
Ar
FJ
qe
HB
JD
HL
VX
VX
JD
HO
JD
Xs
JD
JD
JD
JD
JD
fD
qe
qe
qe
qe
qe
nz
qe
qe
qe
Em
"}
(22,1,1) = {"
qe
qe
qe
qe
qe
OH
OH
OH
OH
qe
HB
JD
JD
JD
Gr
cE
HO
Nx
Oa
cE
cE
JD
JD
JD
Et
qe
qe
qe
qe
qe
qe
qe
nz
qe
qe
"}
(23,1,1) = {"
qe
qe
qe
qe
qe
OH
rl
rl
OH
qe
HB
HB
HB
HB
HB
HB
Wh
Wh
HB
HB
Wh
HB
HB
Ar
nm
qe
qe
qe
Za
qe
qe
qe
qe
qe
qe
"}
(24,1,1) = {"
qe
qe
qe
qe
OH
OH
rl
rl
OH
qe
OB
HB
HB
HB
Qg
HB
HB
Wh
Wh
Wh
Wh
Wh
Wh
Wh
HB
qe
qe
qe
qe
qe
qe
Za
qe
qe
qe
"}
(25,1,1) = {"
qe
qe
qe
OH
rl
rl
OH
OH
OH
Em
HB
HB
HB
HB
HB
HB
HB
HB
HB
Wh
Wh
HB
Wh
Wh
Wh
Wh
qe
qe
qe
qe
qe
qe
qe
qe
qe
"}
(26,1,1) = {"
qe
qe
OH
rl
rl
OH
Em
Em
Ar
qe
qe
OB
HB
HB
HB
HB
OB
HB
HB
HB
Wh
Wh
Wh
Qg
HB
Wh
Wh
qe
qe
nz
qe
qe
nz
qe
qe
"}
(27,1,1) = {"
qe
OH
OH
OH
OH
Em
qe
qe
qe
Za
Ar
HB
OH
OH
OH
OH
Em
HB
HB
OB
HB
Wh
Wh
Wh
Wh
Wh
Wh
Wh
qe
qe
qe
qe
qe
qe
qe
"}
(28,1,1) = {"
OH
OH
rl
OH
qe
qe
qe
qe
nz
qe
OH
OH
OH
OH
rl
OH
OH
OH
HB
Em
OH
OH
HB
Wh
HB
Wh
Wh
Wh
Wh
Za
qe
qe
qe
qe
qe
"}
(29,1,1) = {"
OH
rl
OH
qe
qe
qe
Za
qe
qe
Em
OH
OH
rl
rl
rl
OH
OH
OH
OH
OH
OH
OH
HB
Wh
HB
Wh
Wh
Wh
Wh
Wh
Wh
qe
qe
nz
qe
"}
(30,1,1) = {"
OH
OH
qe
qe
qe
qe
qe
qe
Em
OH
OH
OH
rl
rl
OH
OH
rl
OH
OH
OH
OH
OH
OB
HB
HB
qe
Wh
Wh
Wh
Wh
qe
qe
qe
qe
qe
"}
