//MAP CONVERTED BY dmm2tgm.py THIS HEADER COMMENT PREVENTS RECONVERSION, DO NOT REMOVE
"a" = (
/turf/open/floor/rogue/dirt,
/area/rogue/outdoors/mountains)
"c" = (
/turf/closed/mineral/random/rogue/high,
/area/rogue/outdoors/mountains)
"e" = (
/obj/structure/fluff/railing/fence,
/obj/structure/fluff/railing/fence{
	dir = 4
	},
/turf/open/floor/rogue/dirt,
/area/rogue/outdoors/mountains)
"g" = (
/obj/structure/fluff/railing/fence{
	dir = 4
	},
/turf/open/floor/rogue/naturalstone,
/area/rogue/outdoors/mountains)
"h" = (
/obj/item/storage/roguebag,
/turf/open/floor/rogue/naturalstone,
/area/rogue/outdoors/mountains)
"k" = (
/turf/closed/mineral/random/rogue/med,
/area/rogue/outdoors/mountains)
"l" = (
/obj/structure/bed/rogue/sleepingbag,
/turf/open/floor/rogue/naturalstone,
/area/rogue/outdoors/mountains)
"n" = (
/obj/structure/flora/newtree,
/turf/open/floor/rogue/grass,
/area/rogue/outdoors/mountains)
"o" = (
/obj/item/grown/log/tree/small,
/obj/structure/closet/crate/chest/crafted,
/obj/item/reagent_containers/powder/salt,
/obj/item/rogueore/coal,
/turf/open/floor/rogue/naturalstone,
/area/rogue/outdoors/mountains)
"r" = (
/turf/closed/mineral/random/rogue/med,
/area/rogue)
"s" = (
/obj/item/rope,
/turf/open/floor/rogue/naturalstone,
/area/rogue/outdoors/mountains)
"t" = (
/obj/structure/ladder/earth,
/turf/open/floor/rogue/naturalstone,
/area/rogue/outdoors/mountains)
"u" = (
/obj/item/reagent_containers/glass/bottle/waterskin,
/turf/open/floor/rogue/naturalstone,
/area/rogue/outdoors/mountains)
"w" = (
/turf/open/floor/rogue/grass,
/area/rogue/outdoors/mountains)
"x" = (
/obj/structure/fluff/railing/fence{
	dir = 4
	},
/turf/open/floor/rogue/dirt,
/area/rogue/outdoors/mountains)
"y" = (
/obj/machinery/light/rogue/campfire/densefire,
/turf/open/floor/rogue/naturalstone,
/area/rogue/outdoors/mountains)
"z" = (
/obj/structure/closet/crate/chest/crafted,
/obj/item/reagent_containers/food/snacks/rogue/meat/salami/slice,
/obj/item/reagent_containers/food/snacks/rogue/cheddarslice/aged,
/obj/item/reagent_containers/food/snacks/fat/salo/slice,
/obj/item/reagent_containers/food/snacks/rogue/saltfish,
/turf/open/floor/rogue/naturalstone,
/area/rogue/outdoors/mountains)
"D" = (
/obj/item/rogueweapon/pick,
/turf/open/floor/rogue/naturalstone,
/area/rogue/outdoors/mountains)
"E" = (
/turf/open/water,
/area/rogue/outdoors/mountains)
"G" = (
/turf/open/floor/rogue/naturalstone,
/area/rogue/outdoors/mountains)
"H" = (
/obj/structure/fluff/railing/fence,
/turf/open/floor/rogue/dirt,
/area/rogue/outdoors/mountains)
"I" = (
/turf/open/water/river,
/area/rogue/outdoors/mountains)
"J" = (
/obj/structure/flora/newtree,
/turf/open/floor/rogue/dirt,
/area/rogue/outdoors/mountains)
"K" = (
/turf/open/transparent/openspace,
/area/rogue)
"O" = (
/obj/item/restraints/legcuffs/beartrap/armed/camouflage,
/obj/structure/closet/crate/chest/crafted,
/turf/open/floor/rogue/naturalstone,
/area/rogue/outdoors/mountains)
"P" = (
/obj/structure/ladder/earth,
/turf/open/floor/rogue/naturalstone,
/area/rogue)
"R" = (
/obj/structure/fluff/railing/fence{
	dir = 4
	},
/turf/open/floor/rogue/grass,
/area/rogue/outdoors/mountains)
"U" = (
/obj/item/sleepingbag,
/turf/open/floor/rogue/naturalstone,
/area/rogue/outdoors/mountains)
"V" = (
/obj/item/candle/yellow/lit/infinite/strong,
/turf/open/floor/rogue/naturalstone,
/area/rogue/outdoors/mountains)
"W" = (
/obj/item/reagent_containers/glass/cup,
/turf/open/floor/rogue/naturalstone,
/area/rogue/outdoors/mountains)
"Y" = (
/turf/open/floor/rogue/naturalstone,
/area/rogue)
"Z" = (
/obj/structure/ladder/earth,
/turf/open/transparent/openspace,
/area/rogue)

(1,1,1) = {"
r
r
r
r
r
r
r
r
r
r
r
r
r
r
r
r
r
r
r
r
r
r
r
r
r
r
r
r
r
r
r
r
r
r
r
"}
(2,1,1) = {"
r
r
r
r
r
r
r
r
r
r
r
r
r
r
r
r
r
r
r
r
r
r
r
r
r
r
r
r
r
r
r
r
r
r
r
"}
(3,1,1) = {"
r
r
r
r
r
r
r
r
r
r
r
r
r
r
r
r
r
r
r
r
r
r
r
r
r
r
r
r
r
r
r
r
r
r
r
"}
(4,1,1) = {"
r
r
r
r
r
r
r
r
r
r
r
r
r
r
r
r
r
r
r
r
r
r
r
r
r
r
r
r
r
r
r
r
r
r
r
"}
(5,1,1) = {"
r
r
r
r
r
r
r
r
Y
Y
Y
Y
Y
Y
Y
r
r
r
r
r
r
r
r
r
r
r
r
r
r
r
r
r
r
r
r
"}
(6,1,1) = {"
r
r
r
r
r
r
r
r
Y
Y
Y
Y
Y
Y
Y
r
r
r
r
r
r
r
r
r
r
r
r
r
r
r
r
r
r
r
r
"}
(7,1,1) = {"
r
r
r
r
r
r
r
r
Y
Y
Y
Y
Y
Y
Y
r
r
r
r
r
r
r
r
r
r
r
r
r
r
r
r
r
r
r
r
"}
(8,1,1) = {"
r
r
r
r
r
r
r
r
Y
Y
Y
Y
P
Y
Y
r
r
r
r
r
r
r
r
r
r
r
r
r
r
r
r
r
r
r
r
"}
(9,1,1) = {"
r
r
r
r
r
r
r
r
Y
Y
Y
Y
Y
Y
Y
r
r
r
r
r
r
r
r
r
r
r
r
r
r
r
r
r
r
r
r
"}
(10,1,1) = {"
r
r
r
r
r
r
r
r
Y
Y
Y
Y
Y
Y
Y
r
r
r
r
r
r
r
r
r
r
r
r
r
r
r
r
r
r
r
r
"}
(11,1,1) = {"
r
r
r
r
r
r
r
r
Y
Y
Y
Y
Y
Y
Y
r
r
r
r
r
r
r
r
r
r
r
r
r
r
r
r
r
r
r
r
"}
(12,1,1) = {"
r
r
r
r
r
r
r
r
r
r
r
r
r
r
r
r
r
r
r
r
r
r
r
r
r
r
r
r
r
r
r
r
r
r
r
"}
(13,1,1) = {"
r
r
r
r
r
r
r
r
r
r
r
r
r
r
r
r
r
r
r
r
r
r
r
r
r
r
r
r
r
r
r
r
r
r
r
"}
(14,1,1) = {"
r
r
r
r
r
r
r
r
r
r
r
r
r
r
r
r
r
r
r
r
r
r
r
r
r
r
r
r
r
r
r
r
r
r
r
"}
(15,1,1) = {"
r
r
r
r
r
r
r
r
r
r
r
r
r
r
r
r
r
r
r
r
r
r
r
r
r
r
r
r
r
r
r
r
r
r
r
"}
(16,1,1) = {"
r
r
r
r
r
r
r
r
r
r
r
r
r
r
r
r
r
r
r
r
r
r
r
r
r
r
r
r
r
r
r
r
r
r
r
"}
(17,1,1) = {"
r
r
r
r
r
r
r
r
r
r
r
r
r
r
r
r
r
r
r
r
r
r
r
r
r
r
r
r
r
r
r
r
r
r
r
"}
(18,1,1) = {"
r
r
r
r
r
r
r
r
r
r
r
r
r
r
r
r
r
r
r
r
r
r
r
r
r
r
r
r
r
r
r
r
r
r
r
"}
(19,1,1) = {"
r
r
r
r
r
r
r
r
r
r
r
r
r
r
r
r
r
r
r
r
r
r
r
r
r
r
r
r
r
r
r
r
r
r
r
"}
(20,1,1) = {"
r
r
r
r
r
r
r
r
r
r
r
r
r
r
r
r
r
r
r
r
r
r
r
r
r
r
r
r
r
r
r
r
r
r
r
"}
(21,1,1) = {"
r
r
r
r
r
r
r
r
r
r
r
r
r
r
r
r
r
r
r
r
r
r
r
r
r
r
r
r
r
r
r
r
r
r
r
"}
(22,1,1) = {"
r
r
r
r
r
r
r
r
r
r
r
r
r
r
r
r
r
r
r
r
r
r
r
r
r
r
r
r
r
r
r
r
r
r
r
"}
(23,1,1) = {"
r
r
r
r
r
r
r
r
r
r
r
r
r
r
r
r
r
r
r
r
r
r
r
r
r
r
r
r
r
r
r
r
r
r
r
"}
(24,1,1) = {"
r
r
r
r
r
r
r
r
r
r
r
r
r
r
r
r
r
r
r
r
r
r
r
r
r
r
r
r
r
r
r
r
r
r
r
"}
(25,1,1) = {"
r
r
r
r
r
r
r
r
r
r
r
r
r
r
r
r
r
r
r
r
r
r
r
r
r
r
r
r
r
r
r
r
r
r
r
"}
(26,1,1) = {"
r
r
r
r
r
r
r
r
r
r
r
r
r
r
r
r
r
r
r
r
r
r
r
r
r
r
r
r
r
r
r
r
r
r
r
"}
(27,1,1) = {"
r
r
r
r
r
r
r
r
r
r
r
r
r
r
r
r
r
r
r
r
r
r
r
r
r
r
r
r
r
r
r
r
r
r
r
"}
(28,1,1) = {"
r
r
r
r
r
r
r
r
r
r
r
r
r
r
r
r
r
r
r
r
r
r
r
r
r
r
r
r
r
r
r
r
r
r
r
"}
(29,1,1) = {"
r
r
r
r
r
r
r
r
r
r
r
r
r
r
r
r
r
r
r
r
r
r
r
r
r
r
r
r
r
r
r
r
r
r
r
"}
(30,1,1) = {"
r
r
r
r
r
r
r
r
r
r
r
r
r
r
r
r
r
r
r
r
r
r
r
r
r
r
r
r
r
r
r
r
r
r
r
"}

(1,1,2) = {"
w
w
w
w
n
w
w
a
w
w
w
w
w
w
a
w
w
w
w
w
w
w
a
a
a
a
a
a
a
a
w
w
a
a
a
"}
(2,1,2) = {"
w
w
a
a
w
w
w
a
k
k
k
k
k
k
k
a
a
a
w
w
w
w
a
a
a
a
a
a
a
a
w
n
a
a
a
"}
(3,1,2) = {"
w
w
a
w
a
a
k
k
c
k
c
k
k
c
k
k
w
w
a
a
w
w
a
a
a
a
a
a
a
w
a
a
a
a
a
"}
(4,1,2) = {"
w
n
a
a
w
k
k
k
c
k
c
k
c
k
c
k
k
w
w
a
w
w
J
a
a
w
n
a
a
w
a
a
w
w
a
"}
(5,1,2) = {"
w
w
a
a
k
k
c
k
k
k
k
k
k
k
k
k
k
w
w
a
w
w
a
a
w
a
w
a
a
a
a
a
a
w
a
"}
(6,1,2) = {"
w
w
w
w
k
k
z
G
G
G
y
G
G
k
k
c
k
w
w
w
w
a
a
a
w
a
w
a
a
w
a
a
a
w
a
"}
(7,1,2) = {"
w
w
w
a
k
c
k
s
D
G
W
G
k
k
k
k
k
w
w
a
a
w
a
a
w
w
J
J
a
w
a
a
a
w
a
"}
(8,1,2) = {"
w
w
w
a
k
k
k
U
h
G
G
G
t
k
k
c
k
w
w
w
a
w
a
a
a
w
a
a
a
w
a
a
J
a
w
"}
(9,1,2) = {"
w
w
w
a
k
c
k
k
l
u
G
G
k
G
k
k
k
w
w
w
w
a
a
a
w
E
E
a
a
a
a
a
a
a
a
"}
(10,1,2) = {"
w
w
w
a
w
k
c
k
o
G
G
G
G
G
k
k
k
w
w
a
a
a
a
w
E
E
E
E
w
a
J
a
a
a
a
"}
(11,1,2) = {"
w
w
w
a
w
k
k
k
w
G
G
G
G
G
V
k
w
w
w
w
a
w
a
a
E
E
E
E
w
w
w
a
a
a
a
"}
(12,1,2) = {"
w
n
a
a
a
w
k
k
k
G
G
G
G
G
k
w
w
w
w
a
w
a
a
a
E
E
E
E
E
w
a
a
a
a
a
"}
(13,1,2) = {"
w
w
a
w
a
w
w
k
k
k
G
G
G
w
H
w
w
w
w
w
w
a
a
E
E
E
E
E
E
a
w
w
a
a
a
"}
(14,1,2) = {"
w
w
w
a
w
w
a
a
k
R
g
g
O
x
e
w
w
w
a
a
w
a
E
E
E
E
E
E
E
a
a
a
w
w
w
"}
(15,1,2) = {"
w
w
w
w
n
a
w
w
w
w
w
w
w
w
w
w
w
w
a
a
w
E
E
E
E
E
E
E
w
a
a
w
a
w
a
"}
(16,1,2) = {"
w
w
w
a
a
a
w
w
w
w
w
w
w
w
w
w
w
a
a
w
E
E
E
E
E
E
E
a
a
w
a
w
a
a
n
"}
(17,1,2) = {"
w
w
a
a
w
w
a
w
w
w
w
w
w
w
w
w
w
a
a
E
E
E
E
E
E
E
a
a
w
a
w
a
a
a
w
"}
(18,1,2) = {"
w
w
w
a
w
w
w
w
w
w
w
w
w
a
w
w
w
a
a
E
E
E
E
E
w
a
w
w
a
w
w
a
a
w
a
"}
(19,1,2) = {"
w
w
w
a
a
w
a
w
n
w
a
a
w
w
a
a
w
w
a
a
a
E
I
a
a
a
a
a
a
a
w
a
n
w
a
"}
(20,1,2) = {"
w
w
w
a
J
a
w
w
w
a
a
w
a
a
w
w
n
a
a
a
w
w
a
a
w
a
a
a
a
w
w
a
w
a
a
"}
(21,1,2) = {"
w
w
w
a
w
a
w
w
w
a
w
a
a
n
w
w
w
a
a
a
a
w
w
w
a
a
w
a
a
w
a
a
w
a
a
"}
(22,1,2) = {"
w
w
w
a
w
w
a
w
a
w
w
w
w
w
w
w
w
a
k
k
k
w
a
a
a
a
a
n
w
a
a
a
w
a
a
"}
(23,1,2) = {"
w
w
w
w
w
w
w
w
w
w
n
w
w
w
w
w
k
k
k
k
c
k
w
a
a
a
a
w
a
a
J
a
w
a
a
"}
(24,1,2) = {"
w
w
w
w
a
w
w
w
a
w
w
w
w
w
w
k
k
c
k
k
k
k
k
a
a
a
a
w
a
a
a
a
w
J
a
"}
(25,1,2) = {"
w
w
n
n
w
a
a
w
a
a
w
w
w
J
w
k
k
c
k
c
k
k
k
k
a
a
a
w
a
a
a
w
w
a
a
"}
(26,1,2) = {"
w
w
w
w
n
w
w
a
w
w
a
a
w
a
k
k
k
k
k
k
k
c
k
a
a
a
a
a
a
a
w
w
a
J
a
"}
(27,1,2) = {"
w
w
w
w
w
w
a
J
a
a
a
a
a
w
k
c
k
k
c
k
k
k
J
a
a
a
w
a
a
w
w
w
a
a
a
"}
(28,1,2) = {"
w
w
w
w
w
n
w
a
a
a
n
a
w
k
k
k
k
c
k
c
k
k
a
a
a
w
w
a
a
a
J
a
a
a
a
"}
(29,1,2) = {"
w
w
w
w
w
w
w
w
a
a
a
a
w
k
w
k
k
k
k
k
k
w
w
w
w
w
n
w
w
w
w
w
w
n
w
"}
(30,1,2) = {"
w
w
w
w
w
w
w
w
w
w
a
w
w
w
w
w
w
w
w
w
w
w
w
w
w
w
w
w
w
w
w
w
w
w
w
"}

(1,1,3) = {"
K
K
K
K
K
K
K
K
K
K
K
K
K
K
K
K
K
K
K
K
K
K
K
K
K
K
K
K
K
K
K
K
K
K
K
"}
(2,1,3) = {"
K
K
K
K
K
K
K
K
r
r
r
r
r
r
r
K
K
K
K
K
K
K
K
K
K
K
K
K
K
K
K
K
K
K
K
"}
(3,1,3) = {"
K
K
K
K
K
K
r
r
r
r
r
r
r
r
r
r
K
K
K
K
K
K
K
K
K
K
K
K
K
K
K
K
K
K
K
"}
(4,1,3) = {"
K
K
K
K
K
r
r
r
r
r
r
r
r
r
r
r
r
K
K
K
K
K
K
K
K
K
K
K
K
K
K
K
K
K
K
"}
(5,1,3) = {"
K
K
K
K
r
r
r
r
r
r
r
r
r
r
r
r
r
K
K
K
K
K
K
K
K
K
K
K
K
K
K
K
K
K
K
"}
(6,1,3) = {"
K
K
K
K
r
r
r
K
K
K
K
K
K
r
r
r
r
K
K
K
K
K
K
K
K
K
K
K
K
K
K
K
K
K
K
"}
(7,1,3) = {"
K
K
K
K
r
r
r
K
K
K
K
Y
Y
Y
r
r
r
K
K
K
K
K
K
K
K
K
K
K
K
K
K
K
K
K
K
"}
(8,1,3) = {"
K
K
K
K
r
r
r
K
K
K
Y
Y
Z
Y
r
r
r
K
K
K
K
K
K
K
K
K
K
K
K
K
K
K
K
K
K
"}
(9,1,3) = {"
K
K
K
K
r
r
r
r
K
K
Y
Y
Y
Y
r
r
r
K
K
K
K
K
K
K
K
K
K
K
K
K
K
K
K
K
K
"}
(10,1,3) = {"
K
K
K
K
K
r
r
r
K
K
K
Y
Y
Y
r
r
r
K
K
K
K
K
K
K
K
K
K
K
K
K
K
K
K
K
K
"}
(11,1,3) = {"
K
K
K
K
K
r
r
r
K
K
K
K
K
Y
Y
r
K
K
K
K
K
K
K
K
K
K
K
K
K
K
K
K
K
K
K
"}
(12,1,3) = {"
K
K
K
K
K
K
r
r
r
K
K
K
K
Y
Y
K
K
K
K
K
K
K
K
K
K
K
K
K
K
K
K
K
K
K
K
"}
(13,1,3) = {"
K
K
K
K
K
K
K
r
r
Y
Y
Y
Y
Y
Y
K
K
K
K
K
K
K
K
K
K
K
K
K
K
K
K
K
K
K
K
"}
(14,1,3) = {"
K
K
K
K
K
K
K
K
Y
K
K
K
K
K
K
K
K
K
K
K
K
K
K
K
K
K
K
K
K
K
K
K
K
K
K
"}
(15,1,3) = {"
K
K
K
K
K
K
K
K
K
K
K
K
K
K
K
K
K
K
K
K
K
K
K
K
K
K
K
K
K
K
K
K
K
K
K
"}
(16,1,3) = {"
K
K
K
K
K
K
K
K
K
K
K
K
K
K
K
K
K
K
K
K
K
K
K
K
K
K
K
K
K
K
K
K
K
K
K
"}
(17,1,3) = {"
K
K
K
K
K
K
K
K
K
K
K
K
K
K
K
K
K
K
K
K
K
K
K
K
K
K
K
K
K
K
K
K
K
K
K
"}
(18,1,3) = {"
K
K
K
K
K
K
K
K
K
K
K
K
K
K
K
K
K
K
K
K
K
K
K
K
K
K
K
K
K
K
K
K
K
K
K
"}
(19,1,3) = {"
K
K
K
K
K
K
K
K
K
K
K
K
K
K
K
K
K
K
K
K
K
K
K
K
K
K
K
K
K
K
K
K
K
K
K
"}
(20,1,3) = {"
K
K
K
K
K
K
K
K
K
K
K
K
K
K
K
K
K
K
K
K
K
K
K
K
K
K
K
K
K
K
K
K
K
K
K
"}
(21,1,3) = {"
K
K
K
K
K
K
K
K
K
K
K
K
K
K
K
K
K
K
K
K
K
K
K
K
K
K
K
K
K
K
K
K
K
K
K
"}
(22,1,3) = {"
K
K
K
K
K
K
K
K
K
K
K
K
K
K
K
K
K
K
r
r
r
K
K
K
K
K
K
K
K
K
K
K
K
K
K
"}
(23,1,3) = {"
K
K
K
K
K
K
K
K
K
K
K
K
K
K
K
K
r
r
r
r
r
r
K
K
K
K
K
K
K
K
K
K
K
K
K
"}
(24,1,3) = {"
K
K
K
K
K
K
K
K
K
K
K
K
K
K
K
r
r
r
r
r
r
r
r
K
K
K
K
K
K
K
K
K
K
K
K
"}
(25,1,3) = {"
K
K
K
K
K
K
K
K
K
K
K
K
K
K
K
r
r
r
r
r
r
r
r
r
K
K
K
K
K
K
K
K
K
K
K
"}
(26,1,3) = {"
K
K
K
K
K
K
K
K
K
K
K
K
K
K
r
r
r
r
r
r
r
r
r
K
K
K
K
K
K
K
K
K
K
K
K
"}
(27,1,3) = {"
K
K
K
K
K
K
K
K
K
K
K
K
K
K
r
r
r
r
r
r
r
r
K
K
K
K
K
K
K
K
K
K
K
K
K
"}
(28,1,3) = {"
K
K
K
K
K
K
K
K
K
K
K
K
K
r
r
r
r
r
r
r
r
r
K
K
K
K
K
K
K
K
K
K
K
K
K
"}
(29,1,3) = {"
K
K
K
K
K
K
K
K
K
K
K
K
K
r
K
r
r
r
r
r
r
K
K
K
K
K
K
K
K
K
K
K
K
K
K
"}
(30,1,3) = {"
K
K
K
K
K
K
K
K
K
K
K
K
K
K
K
K
K
K
K
K
K
K
K
K
K
K
K
K
K
K
K
K
K
K
K
"}
