//MAP CONVERTED BY dmm2tgm.py THIS HEADER COMMENT PREVENTS RECONVERSION, DO NOT REMOVE
"a" = (
/turf/open/floor/rogue/dirt,
/area/rogue/outdoors/mountains)
"c" = (
/turf/closed/mineral/random/rogue/high,
/area/rogue/outdoors/mountains)
"e" = (
/obj/structure/fluff/railing/fence,
/obj/structure/fluff/railing/fence{
	dir = 4
	},
/turf/open/floor/rogue/dirt,
/area/rogue/outdoors/mountains)
"g" = (
/obj/structure/fluff/railing/fence{
	dir = 4
	},
/turf/open/floor/rogue/naturalstone,
/area/rogue/outdoors/mountains)
"h" = (
/obj/item/storage/roguebag,
/turf/open/floor/rogue/naturalstone,
/area/rogue/outdoors/mountains)
"k" = (
/turf/closed/mineral/random/rogue/med,
/area/rogue/outdoors/mountains)
"l" = (
/obj/structure/bed/rogue/sleepingbag,
/turf/open/floor/rogue/naturalstone,
/area/rogue/outdoors/mountains)
"n" = (
/obj/structure/flora/newtree,
/turf/open/floor/rogue/grass,
/area/rogue/outdoors/mountains)
"o" = (
/obj/item/grown/log/tree/small,
/obj/structure/closet/crate/chest/crafted,
/obj/item/reagent_containers/powder/salt,
/obj/item/rogueore/coal,
/turf/open/floor/rogue/naturalstone,
/area/rogue/outdoors/mountains)
"s" = (
/obj/item/rope,
/turf/open/floor/rogue/naturalstone,
/area/rogue/outdoors/mountains)
"t" = (
/obj/structure/ladder/earth,
/turf/open/floor/rogue/naturalstone,
/area/rogue/outdoors/mountains)
"u" = (
/obj/item/reagent_containers/glass/bottle/waterskin,
/turf/open/floor/rogue/naturalstone,
/area/rogue/outdoors/mountains)
"w" = (
/turf/open/floor/rogue/grass,
/area/rogue/outdoors/mountains)
"x" = (
/obj/structure/fluff/railing/fence{
	dir = 4
	},
/turf/open/floor/rogue/dirt,
/area/rogue/outdoors/mountains)
"y" = (
/obj/machinery/light/rogue/campfire/densefire,
/turf/open/floor/rogue/naturalstone,
/area/rogue/outdoors/mountains)
"z" = (
/obj/structure/closet/crate/chest/crafted,
/obj/item/reagent_containers/food/snacks/rogue/meat/salami/slice,
/obj/item/reagent_containers/food/snacks/rogue/cheddarslice/aged,
/obj/item/reagent_containers/food/snacks/fat/salo/slice,
/obj/item/reagent_containers/food/snacks/rogue/saltfish,
/turf/open/floor/rogue/naturalstone,
/area/rogue/outdoors/mountains)
"D" = (
/obj/item/rogueweapon/pick,
/turf/open/floor/rogue/naturalstone,
/area/rogue/outdoors/mountains)
"G" = (
/turf/open/floor/rogue/naturalstone,
/area/rogue/outdoors/mountains)
"H" = (
/obj/structure/fluff/railing/fence,
/turf/open/floor/rogue/dirt,
/area/rogue/outdoors/mountains)
"I" = (
/turf/open/water/river,
/area/rogue/outdoors/mountains)
"J" = (
/obj/structure/flora/newtree,
/turf/open/floor/rogue/dirt,
/area/rogue/outdoors/mountains)
"O" = (
/obj/item/restraints/legcuffs/beartrap/armed/camouflage,
/obj/structure/closet/crate/chest/crafted,
/turf/open/floor/rogue/naturalstone,
/area/rogue/outdoors/mountains)
"R" = (
/obj/structure/fluff/railing/fence{
	dir = 4
	},
/turf/open/floor/rogue/grass,
/area/rogue/outdoors/mountains)
"U" = (
/obj/item/sleepingbag,
/turf/open/floor/rogue/naturalstone,
/area/rogue/outdoors/mountains)
"V" = (
/obj/item/candle/yellow/lit/infinite/strong,
/turf/open/floor/rogue/naturalstone,
/area/rogue/outdoors/mountains)
"W" = (
/obj/item/reagent_containers/glass/cup,
/turf/open/floor/rogue/naturalstone,
/area/rogue/outdoors/mountains)

(1,1,1) = {"
w
w
w
w
n
w
w
a
w
w
w
w
w
w
a
w
w
w
w
w
w
w
a
a
a
a
a
a
a
a
w
w
a
a
a
"}
(2,1,1) = {"
w
w
a
a
w
w
w
a
k
k
k
k
k
k
k
a
a
a
w
w
w
w
a
a
a
a
a
a
a
a
w
n
a
a
a
"}
(3,1,1) = {"
w
w
a
w
a
a
k
k
c
k
c
k
k
c
k
k
w
w
a
a
w
w
a
a
a
a
a
a
a
w
a
a
a
a
a
"}
(4,1,1) = {"
w
n
a
a
w
k
k
k
c
k
c
k
c
k
c
k
k
w
w
a
w
w
J
a
a
w
n
a
a
w
a
a
w
w
a
"}
(5,1,1) = {"
w
w
a
a
k
k
c
k
k
k
k
k
k
k
k
k
k
w
w
a
w
w
a
a
w
a
w
a
a
a
a
a
a
w
a
"}
(6,1,1) = {"
w
w
w
w
k
k
z
G
G
G
y
G
G
k
k
c
k
w
w
w
w
a
a
a
w
a
w
a
a
w
a
a
a
w
a
"}
(7,1,1) = {"
w
w
w
a
k
c
k
s
D
G
W
G
k
k
k
k
k
w
w
a
a
w
a
a
w
w
J
J
a
w
a
a
a
w
a
"}
(8,1,1) = {"
w
w
w
a
k
k
k
U
h
G
G
G
t
k
k
c
k
w
w
w
a
w
a
a
a
w
a
a
a
w
a
a
J
a
w
"}
(9,1,1) = {"
w
w
w
a
k
c
k
k
l
u
G
G
k
G
k
k
k
w
w
w
w
a
a
a
w
I
w
a
a
a
a
a
a
a
a
"}
(10,1,1) = {"
w
w
w
a
w
k
c
k
o
G
G
G
G
G
k
k
k
w
w
a
a
a
a
w
I
I
I
a
w
a
J
a
a
a
a
"}
(11,1,1) = {"
w
w
w
a
w
k
k
k
w
G
G
G
G
G
V
k
w
w
w
w
a
w
a
a
a
I
I
w
w
w
w
a
a
a
a
"}
(12,1,1) = {"
w
n
a
a
a
w
k
k
k
G
G
G
G
G
k
w
w
w
w
a
w
a
a
a
I
I
I
I
w
w
a
a
a
a
a
"}
(13,1,1) = {"
w
w
a
w
a
w
w
k
k
k
G
G
G
w
H
w
w
w
w
w
w
a
a
I
I
I
I
I
I
a
w
w
a
a
a
"}
(14,1,1) = {"
w
w
w
a
w
w
a
a
k
R
g
g
O
x
e
w
w
w
a
a
w
a
I
I
I
I
I
I
I
a
a
a
w
w
w
"}
(15,1,1) = {"
w
w
w
w
n
a
w
w
w
w
w
w
w
w
w
w
w
w
a
a
w
I
I
I
I
I
I
I
w
a
a
w
a
w
a
"}
(16,1,1) = {"
w
w
w
a
a
a
w
w
w
w
w
w
w
w
w
w
w
a
a
w
I
I
I
I
I
I
I
a
a
w
a
w
a
a
n
"}
(17,1,1) = {"
w
w
a
a
w
w
a
w
w
w
w
w
w
w
w
w
w
a
a
I
I
I
I
I
I
I
a
a
w
a
w
a
a
a
w
"}
(18,1,1) = {"
w
w
w
a
w
w
w
w
w
w
w
w
w
a
w
w
w
a
a
w
I
I
I
I
w
a
w
w
a
w
w
a
a
w
a
"}
(19,1,1) = {"
w
w
w
a
a
w
a
w
n
w
a
a
w
w
a
a
w
w
a
a
a
I
I
a
a
a
a
a
a
a
w
a
n
w
a
"}
(20,1,1) = {"
w
w
w
a
J
a
w
w
w
a
a
w
a
a
w
w
n
a
a
a
w
w
a
a
w
a
a
a
a
w
w
a
w
a
a
"}
(21,1,1) = {"
w
w
w
a
w
a
w
w
w
a
w
a
a
n
w
w
w
a
a
a
a
w
w
w
a
a
w
a
a
w
a
a
w
a
a
"}
(22,1,1) = {"
w
w
w
a
w
w
a
w
a
w
w
w
w
w
w
w
w
a
k
k
k
w
a
a
a
a
a
n
w
a
a
a
w
a
a
"}
(23,1,1) = {"
w
w
w
w
w
w
w
w
w
w
n
w
w
w
w
w
k
k
k
k
c
k
w
a
a
a
a
w
a
a
J
a
w
a
a
"}
(24,1,1) = {"
w
w
w
w
a
w
w
w
a
w
w
w
w
w
w
k
k
c
k
k
k
k
k
a
a
a
a
w
a
a
a
a
w
J
a
"}
(25,1,1) = {"
w
w
n
n
w
a
a
w
a
a
w
w
w
J
w
k
k
c
k
c
k
k
k
k
a
a
a
w
a
a
a
w
w
a
a
"}
(26,1,1) = {"
w
w
w
w
n
w
w
a
w
w
a
a
w
a
k
k
k
k
k
k
k
c
k
a
a
a
a
a
a
a
w
w
a
J
a
"}
(27,1,1) = {"
w
w
w
w
w
w
a
J
a
a
a
a
a
w
k
c
k
k
c
k
k
k
J
a
a
a
w
a
a
w
w
w
a
a
a
"}
(28,1,1) = {"
w
w
w
w
w
n
w
a
a
a
n
a
w
k
k
k
k
c
k
c
k
k
a
a
a
w
w
a
a
a
J
a
a
a
a
"}
(29,1,1) = {"
w
w
w
w
w
w
w
w
a
a
a
a
w
k
w
k
k
k
k
k
k
w
w
w
w
w
n
w
w
w
w
w
w
n
w
"}
(30,1,1) = {"
w
w
w
w
w
w
w
w
w
w
a
w
w
w
w
w
w
w
w
w
w
w
w
w
w
w
w
w
w
w
w
w
w
w
w
"}
