//MAP CONVERTED BY dmm2tgm.py THIS HEADER COMMENT PREVENTS RECONVERSION, DO NOT REMOVE
"aN" = (
/obj/effect/decal/cleanable/blood/gibs/up,
/obj/effect/decal/cleanable/blood/splatter,
/turf/open/floor/rogue/naturalstone,
/area/rogue/outdoors/caves)
"ba" = (
/obj/effect/decal/cleanable/dirt/cobweb,
/obj/item/reagent_containers/food/snacks/smallrat/dead,
/turf/open/floor/rogue/naturalstone,
/area/rogue/outdoors/caves)
"bs" = (
/obj/effect/decal/cleanable/blood,
/obj/structure/spider/stickyweb,
/turf/open/floor/rogue/naturalstone,
/area/rogue/outdoors/caves)
"ca" = (
/turf/open/floor/rogue/naturalstone,
/area/rogue/outdoors/caves)
"ce" = (
/obj/effect/decal/cleanable/dirt/cobweb,
/obj/machinery/light/rogue/firebowl/standing/blue,
/turf/open/floor/rogue/naturalstone,
/area/rogue/outdoors/caves)
"eU" = (
/obj/effect/decal/cleanable/blood/gibs/body,
/turf/open/floor/rogue/naturalstone,
/area/rogue/outdoors/caves)
"fQ" = (
/obj/effect/decal/cleanable/blood/gibs/torso,
/turf/open/floor/rogue/naturalstone,
/area/rogue/outdoors/caves)
"fW" = (
/obj/effect/decal/cleanable/blood/tracks{
	dir = 1
	},
/mob/living/simple_animal/hostile/retaliate/rogue/spider/mutated,
/turf/open/floor/rogue/naturalstone,
/area/rogue/outdoors/caves)
"ga" = (
/obj/item/reagent_containers/food/snacks/smallrat/dead,
/turf/open/floor/rogue/naturalstone,
/area/rogue/outdoors/caves)
"hb" = (
/obj/effect/decal/cleanable/blood/tracks{
	dir = 1
	},
/turf/open/floor/rogue/naturalstone,
/area/rogue/outdoors/caves)
"jz" = (
/obj/effect/decal/cleanable/blood/tracks{
	dir = 6
	},
/turf/open/floor/rogue/naturalstone,
/area/rogue/outdoors/caves)
"lf" = (
/obj/effect/decal/cleanable/blood/tracks,
/turf/open/floor/rogue/naturalstone,
/area/rogue/outdoors/caves)
"mm" = (
/obj/effect/decal/cleanable/blood,
/turf/open/floor/rogue/naturalstone,
/area/rogue/outdoors/caves)
"mN" = (
/obj/effect/decal/cleanable/blood/splatter,
/obj/item/clothing/cloak/raincloak/blue,
/turf/open/floor/rogue/naturalstone,
/area/rogue/outdoors/caves)
"mT" = (
/obj/effect/decal/cleanable/dirt/cobweb,
/mob/living/simple_animal/hostile/retaliate/rogue/spider/mutated,
/turf/open/floor/rogue/naturalstone,
/area/rogue/outdoors/caves)
"ns" = (
/obj/structure/table/wood/fancy,
/obj/item/roguestatue/gold,
/turf/open/floor/rogue/cobble/alt,
/area/rogue/outdoors/caves)
"oJ" = (
/obj/effect/decal/cleanable/blood/gibs/down,
/turf/open/floor/rogue/naturalstone,
/area/rogue/outdoors/caves)
"pa" = (
/obj/machinery/artificer_table,
/obj/item/paper/scroll{
	pixel_x = 0;
	pixel_y = 0;
	info = Hereliesthelegendaryknight,SerEdrictheProtector.Heprotectedtherealmfromgoblininvasions,skeletonhordes,andorcishraids.Hegoesdown,asperhapsthegreatestknightofalltime.
	},
/turf/open/floor/rogue/naturalstone,
/area/rogue/outdoors/caves)
"pn" = (
/obj/structure/fluff/statue/knight/interior,
/turf/open/floor/rogue/naturalstone,
/area/rogue/outdoors/caves)
"qs" = (
/turf/closed/wall/mineral/rogue/decostone/long{
	dir = 1;
	icon_state = "decostone-l"
	},
/area/rogue/outdoors/caves)
"rT" = (
/obj/structure/winch{
	gid = "keepgate";
	redstone_id = "cavegate1"
	},
/turf/open/floor/rogue/naturalstone,
/area/rogue/outdoors/caves)
"sE" = (
/obj/effect/decal/cleanable/blood/splatter,
/obj/item/storage/belt/rogue/pouch/coins/poor,
/turf/open/floor/rogue/naturalstone,
/area/rogue/outdoors/caves)
"tN" = (
/obj/effect/decal/cleanable/dirt/cobweb{
	dir = 4
	},
/obj/item/natural/rock,
/turf/open/floor/rogue/naturalstone,
/area/rogue/outdoors/caves)
"uq" = (
/obj/structure/fluff/walldeco/rpainting/crown,
/turf/closed/wall/mineral/rogue/decostone/long{
	dir = 1;
	icon_state = "decostone-l"
	},
/area/rogue/outdoors/caves)
"vj" = (
/obj/effect/decal/cleanable/dirt/cobweb{
	icon_state = "cobweb2"
	},
/obj/machinery/light/rogue/firebowl/standing/blue,
/turf/open/floor/rogue/naturalstone,
/area/rogue/outdoors/caves)
"vp" = (
/obj/effect/decal/cleanable/blood/splatter,
/obj/item/bodypart/head,
/turf/open/floor/rogue/naturalstone,
/area/rogue/outdoors/caves)
"vq" = (
/obj/structure/mineral_door/bars{
	locked = 1
	},
/turf/open/floor/rogue/naturalstone,
/area/rogue/outdoors/caves)
"vZ" = (
/obj/effect/decal/cleanable/blood/gibs,
/turf/open/floor/rogue/naturalstone,
/area/rogue/outdoors/caves)
"wp" = (
/obj/structure/bars,
/turf/open/floor/rogue/naturalstone,
/area/rogue/outdoors/caves)
"wZ" = (
/obj/structure/spider/stickyweb,
/obj/structure/spider/stickyweb,
/turf/open/floor/rogue/naturalstone,
/area/rogue/outdoors/caves)
"xM" = (
/obj/machinery/light/rogue/firebowl/standing/blue,
/turf/open/floor/rogue/naturalstone,
/area/rogue/outdoors/caves)
"yc" = (
/obj/effect/decal/cleanable/dirt/cobweb{
	dir = 4
	},
/turf/open/floor/rogue/naturalstone,
/area/rogue/outdoors/caves)
"yP" = (
/obj/effect/decal/cleanable/dirt/cobweb{
	dir = 4
	},
/obj/machinery/light/rogue/firebowl/standing/blue,
/turf/open/floor/rogue/cobble/alt,
/area/rogue/outdoors/caves)
"Ab" = (
/obj/structure/table/wood/fancy,
/obj/item/clothing/ring/gold/saffira,
/turf/open/floor/rogue/cobble/alt,
/area/rogue/outdoors/caves)
"Aj" = (
/obj/structure/table/wood/fancy,
/obj/item/clothing/neck/roguetown/psycross/g,
/turf/open/floor/rogue/cobble/alt,
/area/rogue/outdoors/caves)
"Br" = (
/obj/effect/decal/cleanable/blood/gibs/core,
/turf/open/floor/rogue/naturalstone,
/area/rogue/outdoors/caves)
"DO" = (
/obj/structure/lever{
	redstone_id = "cavegate1"
	},
/turf/open/floor/rogue/naturalstone,
/area/rogue/outdoors/caves)
"DY" = (
/obj/structure/spider/stickyweb,
/obj/effect/decal/cleanable/blood/tracks{
	dir = 1
	},
/turf/open/floor/rogue/naturalstone,
/area/rogue/outdoors/caves)
"Fa" = (
/obj/effect/decal/cleanable/blood/gibs/limb,
/turf/open/floor/rogue/naturalstone,
/area/rogue/outdoors/caves)
"FX" = (
/mob/living/carbon/human/species/skeleton/npc/warrior/skilled,
/obj/effect/mapping_helpers/floor_clothing_equipper,
/obj/item/clothing/head/roguetown/helmet/heavy/crusader,
/obj/item/clothing/gloves/roguetown/plate,
/obj/item/clothing/neck/roguetown/bevor,
/obj/item/clothing/under/roguetown/platelegs,
/obj/item/clothing/shoes/roguetown/boots/armor,
/obj/item/clothing/suit/roguetown/armor/chainmail/hauberk,
/obj/item/rogueweapon/sword,
/obj/item/rogueweapon/shield/tower/metal,
/turf/open/floor/rogue/naturalstone,
/area/rogue/outdoors/caves)
"Go" = (
/obj/effect/decal/cleanable/blood/tracks{
	dir = 9
	},
/turf/open/floor/rogue/naturalstone,
/area/rogue/outdoors/caves)
"Jf" = (
/obj/structure/fluff/walldeco/psybanner/red,
/turf/closed/wall/mineral/rogue/decostone,
/area/rogue/outdoors/caves)
"Ke" = (
/obj/item/natural/rock,
/turf/open/floor/rogue/naturalstone,
/area/rogue/outdoors/caves)
"Lj" = (
/turf/open/floor/rogue/cobble/alt,
/area/rogue/outdoors/caves)
"Lv" = (
/obj/structure/bars,
/turf/open/floor/rogue/cobble/alt,
/area/rogue/outdoors/caves)
"Lx" = (
/obj/structure/table/wood/fancy,
/obj/item/rogueweapon/sword/long/forgotten,
/turf/open/floor/rogue/naturalstone,
/area/rogue/outdoors/caves)
"Mr" = (
/turf/closed/mineral/rogue/bedrock,
/area/rogue/outdoors/caves)
"MP" = (
/obj/structure/fluff/statue/knight/interior/r,
/turf/open/floor/rogue/cobble/alt,
/area/rogue/outdoors/caves)
"Nb" = (
/obj/effect/decal/cleanable/blood/gibs,
/obj/effect/decal/cleanable/blood/splatter,
/turf/open/floor/rogue/naturalstone,
/area/rogue/outdoors/caves)
"NR" = (
/turf/closed/wall/mineral/rogue/decostone/long,
/area/rogue/outdoors/caves)
"Op" = (
/obj/effect/decal/cleanable/blood/gibs/up,
/turf/open/floor/rogue/naturalstone,
/area/rogue/outdoors/caves)
"RN" = (
/obj/effect/decal/cleanable/blood/tracks{
	dir = 1
	},
/obj/item/clothing/head/roguetown/bardhat,
/turf/open/floor/rogue/naturalstone,
/area/rogue/outdoors/caves)
"SB" = (
/obj/item/bodypart/head,
/turf/open/floor/rogue/naturalstone,
/area/rogue/outdoors/caves)
"Tj" = (
/obj/effect/decal/cleanable/blood/tracks{
	dir = 8
	},
/turf/open/floor/rogue/naturalstone,
/area/rogue/outdoors/caves)
"Tn" = (
/obj/effect/decal/cleanable/blood/splatter,
/turf/open/floor/rogue/naturalstone,
/area/rogue/outdoors/caves)
"Tr" = (
/obj/effect/decal/cleanable/blood/gibs/old,
/turf/open/floor/rogue/naturalstone,
/area/rogue/outdoors/caves)
"Vl" = (
/mob/living/simple_animal/hostile/retaliate/rogue/spider/mutated,
/turf/open/floor/rogue/naturalstone,
/area/rogue/outdoors/caves)
"Vm" = (
/obj/effect/decal/cleanable/blood/gibs/limb,
/obj/effect/decal/cleanable/blood/splatter,
/obj/effect/decal/cleanable/blood/splatter,
/turf/open/floor/rogue/naturalstone,
/area/rogue/outdoors/caves)
"VA" = (
/obj/effect/decal/cleanable/blood/gibs/body,
/obj/effect/decal/cleanable/blood/splatter,
/turf/open/floor/rogue/naturalstone,
/area/rogue/outdoors/caves)
"Xe" = (
/obj/structure/spider/stickyweb,
/turf/open/floor/rogue/naturalstone,
/area/rogue/outdoors/caves)
"YV" = (
/obj/structure/gate{
	redstone_id = "cavegate1"
	},
/turf/open/floor/rogue/naturalstone,
/area/rogue/outdoors/caves)
"Zi" = (
/obj/item/rogue/instrument/lute,
/turf/open/floor/rogue/naturalstone,
/area/rogue/outdoors/caves)
"ZY" = (
/obj/effect/decal/cleanable/blood/gibs/core,
/obj/effect/decal/cleanable/blood/splatter,
/turf/open/floor/rogue/naturalstone,
/area/rogue/outdoors/caves)

(1,1,1) = {"
Mr
Mr
Mr
Mr
Mr
Fa
Mr
Mr
Mr
Mr
Mr
Mr
Mr
Mr
Mr
Mr
Mr
Jf
NR
Mr
NR
NR
Mr
Mr
Jf
"}
(2,1,1) = {"
Mr
Mr
Mr
Mr
ca
ca
ca
Xe
Mr
Mr
Mr
Mr
Mr
Mr
Mr
Mr
Mr
qs
ce
ca
Lj
pn
Lj
yP
qs
"}
(3,1,1) = {"
Mr
Mr
Mr
ca
mm
ca
ca
vZ
bs
Xe
Xe
Mr
Mr
Xe
Xe
Mr
Mr
Mr
ns
ca
ca
ca
Lj
ca
qs
"}
(4,1,1) = {"
Mr
Mr
Ke
ca
ca
ca
ca
ca
ca
ca
ca
ca
ca
ca
mm
DO
Mr
qs
Ab
ca
Lj
ca
ca
ca
qs
"}
(5,1,1) = {"
Mr
ca
ca
Xe
Mr
ca
ca
ca
ca
ca
mm
ca
ca
ca
ga
eU
Mr
uq
pa
ca
Lj
FX
ca
ca
Mr
"}
(6,1,1) = {"
ca
Vl
Xe
Mr
Mr
Ke
ca
ca
ca
Vl
Xe
Xe
Xe
Mr
Mr
Mr
Mr
qs
Lx
ca
Lj
ca
ca
ca
Mr
"}
(7,1,1) = {"
ca
eU
Mr
Mr
Mr
ca
ca
ca
ca
ca
Mr
Mr
Mr
Mr
Mr
Mr
Mr
Mr
Aj
ca
ca
ca
Lj
Lj
qs
"}
(8,1,1) = {"
ca
ca
Mr
Mr
Mr
ca
mm
Mr
Mr
Mr
Mr
Mr
Xe
Xe
Xe
Xe
Mr
qs
vj
Lj
ca
MP
ca
xM
qs
"}
(9,1,1) = {"
mm
Mr
Mr
Mr
Xe
ca
ca
Mr
Mr
Mr
ca
ca
ca
mm
ca
Xe
Mr
Jf
Lv
vq
wp
Mr
NR
NR
Jf
"}
(10,1,1) = {"
ca
ca
Mr
Mr
Xe
ca
Mr
Mr
Mr
ca
ca
ca
Tr
ca
Ke
Xe
Xe
Mr
fQ
ca
ca
Mr
Mr
Mr
Mr
"}
(11,1,1) = {"
Mr
ca
ca
Mr
Mr
ca
Mr
ca
ca
ca
ca
ca
ca
ca
Xe
Xe
Mr
Mr
mm
ca
ca
Mr
Mr
Mr
Mr
"}
(12,1,1) = {"
Mr
Vl
ca
ca
ca
ca
ca
ca
ga
Mr
Xe
Mr
Mr
ca
Xe
Mr
Mr
Mr
ca
ca
Vl
Xe
Mr
Mr
Mr
"}
(13,1,1) = {"
Mr
Mr
ca
ca
ca
mm
ca
ca
ca
ca
Mr
Mr
Xe
Vl
Xe
Mr
Mr
ca
ca
ca
ca
Br
Xe
Mr
Mr
"}
(14,1,1) = {"
ca
Mr
ca
Fa
ca
ca
Xe
Xe
Mr
ca
ca
ca
ca
ca
Mr
Mr
Mr
Mr
ca
ca
ca
Xe
Mr
Mr
Mr
"}
(15,1,1) = {"
Mr
Mr
ca
ca
ca
Xe
Mr
Mr
Mr
Xe
ca
ca
ca
ca
Mr
Mr
Mr
Mr
Xe
ca
mm
Mr
Mr
Mr
Mr
"}
(16,1,1) = {"
Mr
Mr
ca
mm
ca
Mr
Mr
Mr
Mr
Mr
ca
mm
ca
Mr
Mr
ca
Mr
rT
ca
ca
Mr
Mr
Mr
Mr
Xe
"}
(17,1,1) = {"
ca
Mr
Mr
ca
ca
Mr
Mr
Mr
Mr
Xe
ca
ca
ca
Mr
Vl
ca
YV
ca
ca
ca
Xe
Xe
Xe
Xe
Xe
"}
(18,1,1) = {"
ca
ca
Mr
ca
ca
Xe
Mr
Mr
Xe
ca
ca
Ke
ca
ca
ca
ca
ca
mm
ca
Xe
wZ
Xe
Mr
Mr
Mr
"}
(19,1,1) = {"
Mr
Mr
Mr
Ke
ca
ca
ca
Vl
ca
ca
ca
ca
ca
ca
ca
ca
ca
ga
Ke
Mr
Mr
Mr
Mr
Mr
Mr
"}
(20,1,1) = {"
Mr
Mr
Mr
ca
ca
ca
ca
ca
ca
mm
ca
ca
ca
ca
Xe
Xe
Mr
Xe
Xe
Mr
Mr
Mr
Mr
Mr
Mr
"}
(21,1,1) = {"
Mr
Mr
Xe
ca
ca
Xe
Mr
ca
ca
ca
Mr
Mr
SB
Xe
Mr
Mr
Mr
Mr
Mr
Mr
Mr
Mr
Mr
Mr
Mr
"}
(22,1,1) = {"
Mr
Mr
Xe
ca
Xe
Mr
Mr
Op
ca
ca
Mr
Mr
Mr
Mr
Mr
Mr
Mr
Mr
Mr
Mr
Mr
Mr
Mr
Xe
Mr
"}
(23,1,1) = {"
Mr
Mr
Xe
ca
Mr
Mr
Mr
Mr
ca
ca
tN
Xe
Mr
Mr
Mr
Mr
Mr
Mr
Mr
Mr
mT
ZY
Tn
Xe
Xe
"}
(24,1,1) = {"
Mr
Mr
ca
ca
ca
ca
yc
Mr
ca
ca
ca
Xe
Xe
Xe
Mr
Mr
Mr
Mr
Xe
Xe
mN
oJ
Tn
Xe
Mr
"}
(25,1,1) = {"
Mr
ba
Go
hb
hb
RN
hb
hb
hb
hb
hb
DY
DY
DY
hb
Tn
Xe
Xe
Xe
Tn
VA
Vl
aN
Mr
Mr
"}
(26,1,1) = {"
ca
ca
Tj
ga
ca
ca
Xe
Xe
Xe
ca
ca
Xe
Xe
ca
ca
Tn
fW
Nb
Tn
vp
sE
Tn
Mr
Mr
Mr
"}
(27,1,1) = {"
Tn
lf
jz
Mr
Mr
Mr
Mr
Mr
Mr
Xe
Zi
Xe
Mr
Mr
Xe
Xe
ca
ca
Tn
Vl
Vm
Mr
Mr
Mr
Mr
"}
(28,1,1) = {"
ca
Ke
Mr
Mr
Mr
Mr
Mr
Mr
Mr
Mr
Mr
Mr
Mr
Mr
Mr
Mr
Xe
Ke
Mr
Mr
Mr
Mr
Mr
Mr
Mr
"}
(29,1,1) = {"
Mr
Mr
Mr
Mr
Mr
Mr
Mr
Mr
Mr
Mr
Mr
Mr
Mr
Mr
Mr
Mr
Mr
Mr
Mr
Mr
Mr
Mr
Mr
Mr
Mr
"}
(30,1,1) = {"
Mr
Mr
ca
ca
ca
Mr
Mr
Mr
Mr
ca
ca
ca
ca
ca
Mr
Mr
Mr
Mr
Mr
Mr
ca
ca
ca
ca
ca
"}
