"a" = (/turf/open/floor/rogue/dirt,/area/rogue/outdoors/bog)
"b" = (/turf/closed/mineral/rogue/bedrock,/area/rogue)
"c" = (/obj/structure/flora/roguetree,/turf/open/floor/rogue/dirt,/area/rogue/outdoors/bog)
"d" = (/turf/closed/mineral/rogue/bedrock,/area/rogue/indoors/cave)
"e" = (/turf/open/water/swamp/deep,/area/rogue/outdoors/bog)
"f" = (/obj/machinery/light/rogue/firebowl/standing/blue,/turf/open/floor/rogue/dirt/road,/area/rogue/indoors/cave)
"g" = (/turf/closed/mineral/random/rogue/high,/area/rogue/outdoors/bog)
"h" = (/turf/open/water/cleanshallow,/area/rogue/outdoors/bog)
"i" = (/turf/open/water/cleanshallow,/area/rogue/indoors/cave)
"j" = (/turf/closed/wall/mineral/rogue/craftstone,/area/rogue/outdoors/bog)
"k" = (/obj/structure/flora/roguetree,/turf/closed/mineral/rogue/bedrock,/area/rogue/outdoors/bog)
"l" = (/turf/closed/mineral/random/rogue/high,/area/rogue/indoors/cave)
"m" = (/mob/living/simple_animal/hostile/retaliate/rogue/spider/mutated,/turf/open/floor/rogue/dirt/road,/area/rogue/outdoors/bog)
"n" = (/obj/structure/flora/roguetree,/turf/closed/mineral/rogue/bedrock,/area/rogue)
"o" = (/turf/closed/mineral/rogue/bedrock,/area/rogue/outdoors/bog)
"p" = (/obj/structure/flora/roguetree,/turf/open/water/swamp,/area/rogue/outdoors/bog)
"q" = (/mob/living/simple_animal/hostile/retaliate/rogue/spider/mutated,/turf/open/water/swamp/deep,/area/rogue/outdoors/bog)
"r" = (/turf/open/floor/rogue/dirt,/area/rogue/indoors/cave)
"s" = (/mob/living/simple_animal/hostile/retaliate/rogue/spider,/turf/open/floor/rogue/dirt,/area/rogue/outdoors/bog)
"t" = (/mob/living/simple_animal/hostile/retaliate/rogue/spider,/turf/open/water/swamp,/area/rogue/outdoors/bog)
"u" = (/mob/living/simple_animal/hostile/retaliate/rogue/spider/mutated,/turf/open/floor/rogue/dirt,/area/rogue/outdoors/bog)
"v" = (/obj/structure/portal,/turf/closed/mineral/rogue/bedrock,/area/rogue/outdoors/bog)
"w" = (/turf/open/floor/rogue/dirt/road,/area/rogue/indoors/cave)
"x" = (/obj/effect/landmark/start/adventurerlate{icon_state = "arrow"; dir = 4},/turf/open/floor/rogue/dirt/road,/area/rogue/outdoors/bog)
"y" = (/turf/open/floor/rogue/hexstone,/area/rogue/outdoors/bog)
"z" = (/obj/effect/landmark/start/adventurerlate{icon_state = "arrow"; dir = 8},/turf/open/floor/rogue/dirt/road,/area/rogue/outdoors/bog)
"B" = (/obj/effect/landmark/events/testportal{aportalloc = "bog"},/turf/open/floor/rogue/dirt/road,/area/rogue/outdoors/bog)
"C" = (/obj/structure/flora/roguetree,/turf/open/floor/rogue/dirt/road,/area/rogue/outdoors/bog)
"D" = (/turf/open/floor/rogue/dirt/road,/area/rogue/outdoors/bog)
"F" = (/mob/living/simple_animal/hostile/retaliate/rogue/spider,/turf/open/water/swamp/deep,/area/rogue/outdoors/bog)
"G" = (/turf/open/water/swamp,/area/rogue/outdoors/bog)
"H" = (/obj/structure/flora/roguetree,/turf/open/water/swamp/deep,/area/rogue/outdoors/bog)
"Q" = (/turf/closed/mineral/random/rogue/med,/area/rogue/outdoors/bog)
"U" = (/obj/machinery/light/rogue/firebowl/standing,/turf/open/floor/rogue/hexstone,/area/rogue/outdoors/bog)
"V" = (/obj/effect/landmark/mapGenerator/rogue/bog{endTurfX = 128; endTurfY = 128},/turf/closed/mineral/rogue/bedrock,/area/rogue)
"X" = (/obj/effect/landmark/mapGenerator/sunlights{endTurfX = 128; endTurfY = 128},/turf/closed/mineral/rogue/bedrock,/area/rogue/outdoors/bog)
"Y" = (/obj/structure/fluff/traveltile{aallmig = "rwfieldbog"; aportalgoesto = "bogrtout"; aportalid = "bogrtin"},/turf/open/floor/rogue/dirt/road,/area/rogue/outdoors/bog)
"Z" = (/turf/closed/mineral/rogue/salt,/area/rogue/outdoors/bog)

(1,1,1) = {"
bbbbbbbbbbbbbbbbbbbbbbbbbbbbbbbbbbbbbbbbbbbbbbbbbbbbbbbbbbbbbbbbbbbbbbbbbbbbbbbbbbbbbbbbbbbbbbbbbbbbbbbbbbbbbbbbbbbbbbbbbbbbbbbb
booooooooooDDGGGGGGGGGGppGGGGGGGGGGGGGGGGGGoooooooooooooYYoooooooooooYYGGGGGGGGGGGGGGGGGGGGGGGGGGGQQQQQQQGGGGGGGGQQQQQQQQQQQQQob
booooooooooDDDDDDDDDDDDCCDDDDDDDDDDDGGGGGGGGGGGooooooGGGDDGGGGGGGGGGGDDGGGGGGGGGGGGGGGGGGGGDDDDDDDQQQQQQQDDDGGGDDQQQQQQQQQQQQQob
boooooDDDDCCCCDDDDDDDDDCCDDDDDDDDDDGGGDDDDDDDDDDDDDDDGGGDDGGGGDDDDDDDDDDDDDDDGGGGGGGaaaaaGGDDDDDDDQQQQQQQDDDGGGDQQQQQQQQQQQQQQob
boooooaaaacCCcaaaaaaaaaaaaaaaaaaGGGGGaaaaaaaaaaaaaaaaaGGDDGGGGaaaaaaaDBaaaaaaacaaaaaaaaaGGGaaaaaaaQQQQQQQaaaGGaaQQQQQQQQQQQQQQob
boooeeeGGGcCCcacccaGGGGGGGGGGaaaaGaGaaaaaaaaaaaaaaaaaaaaDDaaGGaacccccDDaacccaaccaaaaaaaGGGGaaaeeeeeeeeeeeeeaGGaaQQQQQQQQQQQQQQob
bkkoeeeGGGaDaaaaaaaGGGGGGGGGGaaaaaaGaaaaaaaGGaaaaccccccaDDaaGGaacccccDDaaaaaaaaccccaaaGGGGGaaaeeeeeeeeeeeeeaGGaaQQQQQQQQQQQQQQob
bkkoeeeeeGaDDaaZaaaGGGGeeGGGGaaaaaaGGaaaaaaGGaGaaccccccaDDaaaaaacccccDDaccccaaaccccaaaaaGGGaaaeeeeeeeeeeeeeaGGaaaaaQQQQQGGGQQQob
bkkDaGeeeGaDDaaaaaGGGeeeeeeGGGaaaaaaaaaaaGGGGaGaaccccccaDaaaaaaaaaaaaDDaccccaaaacccaaaaaGGGaaaeeeeeeeeeeeeeaGGaaaaaaQQQQQGGGQQob
nkkDaGeeeGaaDaaaaaGGGeeeeeeGGGGGaaaaaaaaaaGGGGGaaccccccaDaaaaaaGaaaaaDDaaaaaGaaacccaaaaaGGGaaaeeeeeeeeeeeeeaGaGGaaaaQQQQQGGGQQob
npCDaGeeeGaaCcaaaaGGGeeeeeeeGGGGeeeeeeeeeeeeGGGaaaaaaaaaDaacccaaaGaaaDDaaccaGaaaaccaaaaaaGGaaaeeeeeeeeeeeeeaGGGGaaaaaaaQGGGQQQob
nkCDaGGGeGaaCcaaccaGGeeeeeeeGGaeeeeeeeeeeeeeeGGGaaaaaaaaDaacccaGaGaaaDaaaccaGGGGGpppGGaaaeeeeeeeeeeeeeeeeeeeeeeeaaaaaaaGGGQQQQob
nkCDaaGaGGaaCcaaccaGGeeeeeeeGGaeeeeeeeeeeeeeeGGGaacccaaaDaacccaGGGGaaDaaaccaGGGGGpppGGeeeeeeeeeeeeeeeeeeeeeeeeeeDDDDDDDDDGDDzGob
nkCDaaaaGGaaCcaaaaaGGGGeeeeeGGaeeeeeeeeeeeeeeGGGaacccaaaDaacccaaGGGGGGGGGGGGGGGGGGppGGGGGeeeeeeeeeeeeeeeeeeeeeeeaaaaaaaaGaGGDGob
nkkDaccaaaaaDaaaaaaGGGGGGGeeeGaeeeeeeeeeeeeeeGaGGGpppGGGGGGpppGGGGGGGGGGGGGGGGGGGGppGGaaaeeeeeeeeeeeeeeeeeeeeeeeaaaaaaaaGGGDDGob
nkkDaaaaaaaaDaaaaaaaaaaGGGeeeGaeeeeeeeeeeeeeeGGGGGpppGGGGGGGGGGGGaGGGGGGGGGGGGGGGGpppGaaaeeeeeeeeeeeeeeeeeeeeeeeGaaaaaaaGGGDDGob
nCCDDDDDDDmDDDDDDDaaaaaGGGGeeGaeeeeeeeeeeeeeeGGGGGGGGGGGGGGGGGGGGaGGGGGGGppGaGGGGGppGGaaaaaGGaeeeqeeeeeeeeeaaaaaGGaaaaaGGGaDDGob
nCCDaaaaaaaaaaaaaDacccaaGGGGGGaeeeeeeeeeeeeeeGGGGGGGGGGGGGGGGGGGGDDDDDaeeeeeeeeeaacccaaaaaaGGGeeeeeeeeeeeeeaaaaaGGGaaaaGGaaDGGob
nkoDaoooooaaaacccCccccaaaaaaaaaeeeeeeeqeeeeeeGGGaaaaaaaaaaaaaaaaaaaaaDaeeeeeeeeeaccccaaaaGGGaaeeeeeeeeeeeeeaaaaaaGGGaaaGaaaDGGob
boooooooooooooaccCcaaaaaaaaaaaaeeeeeeeeeeeeeeGGGaacccaaaaaaaaaaaaaaaaDaeeeeeeeeeacccccaaaGaaaaeeeeeeeeeeeeeaaaaaGGGGaGaaaaaDGGob
booooooaaaooaaaccCcaGGGGGGauaaaeeeeeeeeeeeeeeGGGaacccaaaccccccaacccccDaeeeeeeeeeccccaaaaaGaaaaeeeeeeeeeeeeeaaaaaGGGGGaaaaaaDGGob
booooooaaaaaGGGpcCcaGGaaaGGaaaaeeeeeeeeeeeeeeGGGaaaaaaaaccccccaacccccDaeeeeeeeeeccccaaaaaGaaaaaaaaaaaaaaaaaaaaaaGGGGaaaaaaaDGGob
booooosaaaaaGaaaaDaaaaaaaaaaaaaeeeeeeeeeeeeeeGGGaaaaaaaaccccccaacccccGGeeeeeeeeeaaaccccaaGaaaaaaaaaaaaaaaaaaaaaGGGGaaaaaaaGGGGob
boooooaaaaaaaGGaaDacaaaaaaaaaGGeeeeeeeeeeeeeeGGGaaGGaGGaccccccaaaaaaGGGeeeeeeeeeGGGppppGGGGGGGGGGaaaaaaaaaaaaaGGGGGaaaaaaaGGGGob
boooooaaZacaGGaaaDaGGGGGGaGGGGGeeeeeeeeeeeeeeGGaGGaaGGaaaaaaaaaaaaaGGGGeeeeeeeeeGGGGGGGGGGGGGGGGGaaaaaaaaauaaaGGGGaaaaaaaaGGGGob
boooooaaaaaaGaaaaDaGGeeeeeGGGeGGGaaaaaaaaaGGGaGaaaaaGaaaaaaaaaaaaaGGGDaeeeeeeeeeGGGGGGGGGGGGGGGGGaaaaaaaaaaaaGGGaaaaaaaaaGGGGGob
boooooaaaaaaGaaaaDaGGFeeeeeeeeGGGaaaaaaGGGGaaaaaaaGGGaaaaaaaaaacccaaaDaeeeeeeeeeeeeGGGtGGGGGGGGGGGaaaaaaaaaaaaaaaaaaaaaaaGGGGGob
boooooaaaaaaGaccaDaGGeeeeeeeeeeGGaaaaaaGGaaaaaaaaaGGGGaaaaaGaaacccaaaDaeeeeeeeeeeeeaaaaaaaaaaaGGGGGaaaaaaaaaaaaaaaaaaaaaaGGDGGob
boooooaacaaaaaccaDaGGGGGeeeeGGGGGaaaaaaaaaGGaaaaaaGGGGGaaaaGaaaaaaaaaDaaaaaaaaaeeeeaaaaaaaaaaaaaGGGGGaaaaaaaaaaaaaaaaaaaGGaDGGob
boooooaaaaaaaaccaDaaaaaaGGGGGGGGGaaaaaaaaaaGGGaaaaGGGGGaaaaGaaaaaaaasDaaaaaGGGGaGGaaaaaaaaaaaaaGGGaGGaaaaaaaaaaaaaaaaaaaaaaDGGob
boooooGGGGGGGGGGGGGGGGGGGGGGGaaaaaaaaaaaDDDDDGDDDDDDDDDDDDDGDDDDDDDDDDaaaaGGaaaaGGaaaaaaaaaaaGGGaaaaaaaaaaaaaaaaaaaaaaaaaaaDGGob
boooooGGGGGGGGGGGGGGGGGGGGaaaaaaGGaaaaaaGGGGGGaaaaaaGaaaaaaGaaaaaaaaaaaaaGGaaaaaaGaaaGGGGGGaaGGaaaaaaaaaaaaaaaaaaaaaaaaaaaaDGGob
booooaGGGGGGGGGGGGGGGGGGGGaacaaaaGGaaaaaDaaaaaaaaaaGGaaaaaaaaGaaaaaaaacccGGaaasaaGGaaaaGGaaaGGGGaaaaaaaaaaaaaaaaaaaaaaaaaaaDGGob
booooaGGGGGGGGGGGGGGGGGGGGaacaaaaaGGaaaaDaaaaGGGGGGGGGaaaGGGGaGaaGGGaaaaaGGaaaaaaaGaaaaGaaaaaaaGGGGaaaaaaaaaaaaaaaaaaaaaaaaDGQob
booooaGGGGGGGGGGGGGGGGGGppeeHaaaaaaGaaaaDaaaGGGeeeeaeeGaaaGGGaGGGGGGGGGGaaGGGGaaaaaaaaaGaaaaaaaaaaaaaaaaaaaaaaaaaaaaaaaaaaaDGQob
booooooeeeeeeeeeeeeeeeeeHHHeHaaaaaaGaaaaDaaaGGeeeeeeeeGaaaGGGaaGGeeGGGGGaaaGGGaaaaaaaaaaaaaaaaaaaaaaaaaaaaaaaaaaasaaaaaaaaaDQQob
booooeeeeeeeeeeeeeeeeeeeeHHeHcaaaaGGaaaaDaGGeeeeeeeeeeGGccaGGaaGGeeGGGGGGeeeGGGGGGGGaaaaaaaaaaQQQaaGaaaaaaaaaaaaaaaaaaaaaaaDQQob
booooeeeeeeeeeeeeeeeeeeeeHHHHcaaaaGaaaaaDaGGeeeaaaaaeeGGccaGGaaGGeeeeeGGGGeeeeeGGGGGaaaaaaaaQQQQQQGGQaaaaaaaaaGaaaaaaaaaaaaQQQob
bGDDaeeeeeeeeeeeeeeeeeeeeHHHHcaaaaaaaaaaDaaGeeaaaaaaeeeGaaaaaaaGGeGGeeeeeeeeeeeeeeeGaaaaaQQQQQQQQGGQQQaaaaaaaaGGaaaaaQaaaaaQQQob
bGDDaGGeeFeeeeeeeeeeeHHeeeHHHcaaaaaaaaaaDaaGeeaaaZaaGeeGGGaaaaaaaaGGGGGeeqeeeeeeeeeGGaaaaQQQQQGGGGQQQQQQQQQQQQQGQQQQQQaGGaQQQQob
beeeeeGeeeeeeeeeeeeeeeeeeeHHHccaaaaaZaaaDaaGeeaaaauaaeeGGGaaaccaaaGGGGGGGeeeeeeeeeeaaaaaaaQQQQQQQQQQQQQQQQQQQQQGQQQQQQQQGQQQQQob
beeeeeeeeeeeeeeeeeeeeeeeeeHHHcaaaaaGGaaaDaGGGeaaaaaaaeGaGGaaaccaaaGGGGGGGeeeeeeGGGGGaaaaaaaaQQQQQQQQQQQQQQQQQQQGQQQQQQQQGGQQQQob
bGeeeeeeeeeeHHHeeeeeeeeeeeeeHcaaaaaaGaaaDaGGGeeeeeeeeeGGGGGaaaaaaaGGGGGGGaaaGGGGGGaaaaaaaaaaaaQQQQQQQQQQQQQQQQQGQQQQQQQQQGQQQQob
beeeeeGeeeeeeeeeeeeeeeeeeeeaacaaaaaaGGaaDaaGGeeeeeeeeeGGGGGGaaaaaaGGGGGGGaaaaGGGGaaaaaaaaaaaaaaaaaaaaQQQQQQQQQQGQQQaQQaQQQaQQGob
bGGeeeGGGGGGGGGGGGGGGGGGGGGGGcaaaaaaaGaaDaaaGGGGGGGGGGaGGGaGaaaDaaaaaccpccaaaGGaGGaaccccaaaaaaaaaaaaaaaDDDDDDDDDDaaaaaaaaaaQQGob
bGGGGGaaGGGGGGGGGGGGGGppGGGGGcaaaaaaaaaaDaaaaaaaaGGaGaaaaaaGGaaDaaaaacccccaaaaaGGGaaaaaaaaaaaacccaaaaaaDaaaaaaaDDDDDDDDDDDDzDGob
bGGDaaaaaaGGaaaaaDaaaaccaaaaacaaaaaaaaaaDDDDDDDGDDDDDDDDDDDDGGDDDDDDaaaaaaaaaaaGGGaaGGGaaaaaaacccaaaaaaDaaaaaaaaaaaaaaaaaaaaaaob
bGGDaaaaaaGaaaaaaDaaauccaGaaaaaaGGGGaaaaDaaaaGGaaaaaaaaaaaaaaaaDaaaaaaaaaaaaaaaaaGaaGaGGGGaaaacccaaaaaaaaaaaaccaaaaaaacccccaccob
bGGDaaaaaGGaaaaGGDGGaaaaaaGGGGGaGGGGaaaaDaaaGGaaaaGGGaaaaaaaccaDaaaccaaaGGGGGaaaaaaGGaaaaaGaaaaaaaGaaaaaaaaaaaaaaaaaaccccccaccob
bGGDaaaaaGaaaaGGGGGaaaaaaaaaGGGGGGGGaGGaDaaaGGGGGGaaaaaaaaaaccaDaaaaGGGaGGGGaaaaccaGaaaaaaaaaaaaaaGGGGaaaaaaaaaaaaaaccccccccccob
bGGDaaaaaacaaaGGGDGGaaaaaaaaGGeeeeeGGGGGDaaaaaaaaaaaaaaaaaaaaaaDaaaGGGGeeeeGGaaaccaaaaaaaaaaaaaaaaGGaaaaaaaaaaaaaaacccccccccccob
bGGDaacaaaaaaGGaaDaGaaaaccccppeeeeeGGGGGaaaaaaaaaaaaaaeeeeaaaaaDaaGGeeeeeeeGGaaaccaaaaaaaaaaaaaaaaaaaaaaaaaaaaaaacccccooooooccob
bGGDaacaaaaGGaaaaDGGaaaaccccppeeeeeeGGGaacccaaaaaaaaeeeeeeaaaaaDaaGGeeeeeeeeeeGGaaasaaaaaaaZaaaaaaaaaaaaaaaaaaccccccccjvooojccob
bGGDaaaaaaaaGGaaaDaGaaaaccccppeeeeeeGGGGacccaaaaeeeeeeeeeeaaaaaDaaGGeeeeeeeeeeGGaaaaaaaaaaaaaaaaaaaaaaaaaaaaaccccccaaajUyyUjccob
bGGDaaaaaccGDGDDDDDGDDDDCCCCCcaaGeeeGGGGaaaaeeeeeeeeeeeeaaaaaaaDaaGGGeeeqeeeeeGGZaaaaaaaaaaccaaaaaaaaaaaaaaaccccccaaaajyyyyjaaob
bGGDaaaaaaaGGGaaaDaGaaccCCccccaaGeeeGGGaaaaaeeeeeeeeaGGaaaaaaaaDaaGGGGGeeeeeeeGGaaaaaaccaaaccaaaaaaaaaaaaaaacccccaaaaajyyyyjaaob
bGGDaaaaaaaaGGccaDGGaaaaDDaaaaaaGeeeGGaacaaaaGGaaaaaaGaaaaaaaaaDaaGGGGaeeeeeeeGGaaaaaaaaaaaaaaasaaaaaaaaaaacccccaaaaaaaGaaaaaaob
bGGDaaaaGGaaGGaasGGGaaaaDDaaaaaaaGGGGGaaaaaGGGaaaaaaGGaaaacaaaaDaaaaGGGGGGGGGGGGaaaaaaaaaaaaaaaaaaaGGaaaaacccccaasaaGGGaaaaaaaob
bGGDaaaGGaaaGGaaaaaaaaaaDDaaaaaaaaGGGaaaaaGGGGaaaacaaaaaaccaaaaDaaaaGaaaGGGGGaaaaaaaaaaaaaaaaaaaaaGGGGaaaccccccaaaaGGaaaaaaaaaob
bGGDaaaGGGaaaaaaaaaaaaaaDDaaaacaaaaaaaaaaGGaaaaaaaaaaaacccsasaaDaaaaaaaaaaaaaGaGGGGGGGGGaaaaaaGaaGGaGGaGGaaccccaaaaGGaaaaaaaaaob
bDDDaaaaaaaaaaccaccaaaaaaDaaaaaaaaaaacaaaaaaasaaaaaaaacccacaaaaDaaaaaaaaasGGGGaaaGGGaaaaaaaaGGGGGGGGGGaGGaaccccaaaaGGGaaaaaaaaob
bxDDaaaaaaaacccccccccaaaaDaaaaaaaaaaaaaaaaacaaaaaacccccccccaaaaDaaaaaaaaaaaGGGaGGaaaaaaaaaaaGaaaaaaGGaaaGGGGcccaGGGGGGGGaaaaaaob
baaaaaaaaccccccccccccaaaaDaaaaaaaaaaaaaaaaaaaaaaccacccccccaaaaaDaaaaaGaaaaaaaGGaaaaaaaaaaaaaaaaaaaaGaaaaGGGGGGGGGGGGaaaacccaaaob
baaaaaaacccccccccccccccccDaaaaaaaaaaaaaaaaaaaaacacccccccccaaaaaDaaaaGGGaaaaaaGaaaaaaaaaaaGaaaaaaaaaGaaaaGGGGGccaGGGGaaaacccaaaob
bccaaaacccccccccccccccaaaDaaaaaaccccccacacacacccccccccccccaaaaGDaGGGGGaaaaaaaaaaaaaaaaaaGGaaaaaaaaaGaaaaGGGGacccaaaaaaaacccaaaob
bccccccccccccccccccauaaaaDacccccccccccccccccccccccccccacaaaaaGGGGGGGaaaaaaaaaaaaaaaaaaaaGaaaaaaaaaaaaaGaaaaaaccccaaaaaaaaaaaaaob
bccccccccccccaaaaaaGGGaaaDaaaaaaaaaaaaaaaaacccaaaaaaaaaaaaaaaGGGaaaaaaaaaaaaaaaaaaaaaaaaaaaaaaaaaaGaaaaaaaaaaccccaaaaaaaaaaGaaob
bccaaaaaaaaaaaaaaaaGGGaaaDaaaaasaaaaaaaaaaaaaaaaaaaaaaaaaaaaGGGDaaaaaaaaaaaaaaaaaccaaaaaaaaaaaaaaaGGaaaaaacaacccccaaaaaaaaaGaaob
baGGaaaaaaaaaaaaaaaGGGaaaDaaaaaaaaaaaaaaaGaaaaaaaGGaaaaaaaaGGGaDaaaaaaaaaGGGGGGGpppGGGGGGaaaZaGGGGGGaaaaaacaacacccaaaaaaaaaGaaob
baGGaaaaaaaaaaaacaaGGGaaaDDDDDDDDDDDDDDGGGDDDDDDDGGDDDDDDDDGGGGGGGGGGGGGGGGGGGGpppGGpGGGGGGGGGGGGGGGaaaaaacaacaccccaccaaaaaaaaob
baaGGaaaaaaaaaaccaaGGGaaaDaaaaaaaaaaaaaGaaaaaaaaaaGaaaaaaaGGGGGGGGGGGGGGGGGGppppppGpGppppppppppGGGGacccccccaaacccccccccaaaaaaaob
bGGGGaaaaaacccccccaaaaaaaDaGGGGGaaaaaaGGaaaaaaaaaaGaaaaaaaGGaGaDaaaaaaaaaGppppppppGpGppGppppGGaaaGGaGppppppppcacccccccccaaaaaaob
bGGGGaaaaaaaacccccaaaaaaaDaGGGGGaaaaaGGaaaaeeeeeeeeeeeeeeaaaaaaDaaaaaaaaappppppppppGGGGGGGGpGGaaaaGaGGGGGppppcaacaccccccccaacaob
bGGGaaaaaaaaaaaaaaaaaaaaaDaGGGGGaaaaaGGaaeeeeeeeeeeeeeeeeaaaaaaaaaaaaaacaaccccaccaaaaaaaaaaaaaaaaGGaGGGGGppppcaaaaaccaccccaaccob
bGGGaGaaaaaaaaaaasaaaaaaaaaaaaaaaaaaaaaaaeeeeGaaaaaaaaaGGaaaaaaaaaaaacaacaccccccaaaaaaaaaaaaaaaaaGGaGGGGGppppcaaaaaaccccccccccob
bGGDaGaaaaaaaaaaaaaGGGaaGGGaaaaaGGGGaaGGGaaeeeaaaaaaaaaaaaaaaaaaaaaaaaccccccccaaaaaaaaaaaaaaaaaaaaaDDGDCppGGGaaaaaaaaccaacccccob
bGGDaGaaaaaaaaaaaaGGGaaaaaaaaaaGGGGGGGGaaaeeeeaaaaaaaaaaaaaaaaaaaaccaccccccaaaaaaaaasaaaaGaGaaaaaaaDDGGCppGGGDDDDDDDDaaaacccccob
bGGDaGGGGGaaaaaaaGGGGaaaaaaaaGGGaGGGGaaaaaeeaaaaaaaaaaaaaaacacaaaaccccccaaaaaaaGaaaaaaaaaaaaaaaaaccDDGGGGGGGGaaaaaaaDaaaaaaaccob
bGGDGGaaaGGGaaaaaGGaGaaaaaaaaaaaaaGGGGaaaaaaaaaaccccccccccccccccccccccccaaaaaGGGaaaaGaaaGaaaaacaaaaDDGGGGGGGGaaaaaaaDaaaaaaaaaob
bGGDGGaaaaaaaaaaaGGaaGaaaaaaaaaaaaaaaGaaaaaaaccccccccccccccccccccccccacaaaaGGGaaaaeeeeeeaaaGaacaaGaGDGGGGGaaaacccaaaDDDDDDDDzGob
bGGGGGaaaaaaaaaaaaaaaGaaaaaaacccaaaaaaaaaaaaaacacacccccccccaaaaccccaaaaaaaaGaaeeeeeeeeeeaaaGaaaaaGcppGGGGGaaaaaaaaaGaaaaaaGGDGob
bGGGGaaaaaaaaaaaaaaaaaaaaaaacccccccaaaaaaaaaaaaccccaaccccaaaaaaaaaaaaaaaaaaaaaeeeeeeeeeeaaGGaaaGGGcCpGGGGDaaGaaaaaaGGaaaaaGGGGob
bGGDaaaaaaZaaaaaaaaaccauaaaacccccccccaaaaaaaaaaccaccccaaaaaaaaaaaaaaaaaaaaaaaaeeeeeeeeeeGaGaaaaaGGccpGGGGDGaaaacaaaaaaaccaGGGGob
bGGDaaaaaaaaaaaaaaacccaaaaaacccaaaaaaaaaaaGaaaaaccaaaaaaaaaaaaaaaaaaaaaaGaaaaGeeeeeeeeeeGGaaaccaGaaaGGGGGDaaGaGaaaaaaaaaaaGGGGob
bGGDaaaaaaaaaaaaacccccaaaaGaaaaaaaaaaaaaaaGaaaaaaaaaaaaGaGGaaaaacccccaaGGaGeeeeeeeeeeeaaaaaaaccaGaaGGGGGGDaaaGGGGGGaaaaaaaGGGGob
bGGDaaaaaaaaaaaaaccaaaaaaGGGGaaaaaaZaaaaaGGaGaaaaaaaaaaGGGaaaaaaaaaaaaaeeeeeeeeeeaeeGGGaaaaaaaaaGaaGGGGGGDaacpGaGGGGaaaaaaGGGGob
bGGDaaccccaaaaaaaccaaaaaaGGGGaaaaaaaaaaaaGGGGaaaaaaaaaGGaaaaaaaaaaaaaaGeeeeeeeaaaaaaaaGGGaaaaaaaaaaaGGGGDDaaccGaaaGGaaaaaGGGGGob
bGGDaaccccaaaaaaaaaaaaaaaaGGGGaaaaaaaaaaaGGGGaaaaaaaaGGaaaaaaaaaaaaaaaGGGGGGaaaaaaaaaaaaaaGaaaaaaacaGGGGGDaaccaaaaGaaaaaaGGDGGob
bGGDaaccccaaaaaaaaaaaaaaaaGGGGGaaaGGaaaaaGGGGaaGaaaaaGaaaaaaGGaaaGGaaaGGaGGGaaaaaaaaaaaaaaaaaaaaaacaDDGGGGaaaacaaaaaGaaGGGGGGGob
bGGGaaaaaaaaaaaaaaaaZaaaaaaGGaGaaaGGGaGGGGGGGaGGaaaaaGaaaaaGGGaaGGGGGaaaaaaaaaaacccaaaaaaaaaaaaaaaaaDGGDGGaaaacccccaGaaGGGGDDGob
bGGGaaGGaaaaaaaaaaaaaaaaaaaaGGGaaaGaGGGGGGGGGGGaaaaaaaaaaaaGeeeeeeeGaaaaccaaaaaacccaaaaaacccccccaaaaaaaaaaaaaaaaaaaaaGaGaaGGDGob
bGGGaaaGGaGGaGaaaaaaaaaaaaaaaaGGaaGaaaGGaaaGaaaaaaaaaaaaaaaGeeeeeeeGaaaaccaaaaaaaaaaauaaaaaaaaaaaaaaaaaaaaaaaaaaaaaaaGGaaaGDDGob
bGGGaaaaGGaGGGaaaaGGGGpaaaaaaaaaaaGaaaGeeeeGaaaaaaaaaaaaaaGGeeeeeeeGGaaaaaaGaaaaaaaaaaaaaaaaaaaaaaaaaaaaaaaaasaaauaaaaGaaGGDDGob
bGGGaaaaaGGGGaaaaaGGGGGaaaaaaaaaaGGaaaGeeeeaaaaaaaaaaaaaaaGeeeeeeeeGGGaaaaaGaaaaogggoaaooaaaaaaaaaaaaaaccccccaaaaaaaaaaaaGaDDGob
bGGDaaaaaGGaGGaaaaGGGGGGGGGGGGGaGGaaaaGGeeeaaauaaccaaaaaaaGeeeeeeeeGGaaaaaaGaaaooggggggggoooaaaaaaaaaaaccccccaaaaaaaaaaaaGGDDGob
bGGGaaaGGaGGGGGGGGGGGGGGGGGGGGGaaaaaaaGGeeeGaaaaaccaaasaaGGeeeeeeeeeGaaacaaGaaaooooggggggggggggooaaaaaaccccccaaaaaaaaaaaaGGDDGob
bGDDaaaaGGGaGGaaaaGGGGGGGGGGGGGGaaacaaGGGeeaaaaacccaaaaaaGGeeeeeeeeeGaaacaaGGaaaaaoooogggggggggooooaaaaaaaaaaacccccaahhaaGGDDGob
bGDDaaaaaaaaaaaaccaaGGGGGpppGGGGGaaaaaaGGeeGaacccccaaaaaGGGeeeeeeeeeGaGacaaaGaacccaaoogggggggggooooaaaaDDaaaaacccccaahhaaGGGGGob
bGDDaaaaaccaaaaaccaaaaaaacccGeeeeaaaaaaGGeeGaacccccaaaaaaGGeeeeeeeeeGGGaaaaaGaacccaaaogggggggggoooooooaDDDDDDDaaaaaaahhaaaaGGGob
bGDDaaaaaccaaaaaccaaaaaaacccGeeeeGGaaaaGGGGGaaccccccaaaaaaaGGGGGGGGaGGGaaaaaGaaaaaaaaogggggggggoooooooooDDDDDDaaaaaahhhaaaaDDGob
bGDDaaaaaaGaaaaaaaaaaZZaaaaaGGeeeeeGaaaGGGGGaaccccccaaaaaaaaaaaaaaaGGGGGGGaGGaaaaDDDDDgggggggggooooooowwwDDDDDDaaaaahhhaaauDDGob
bGDDaaaaaaaGGaaaaaaaaaaaaaaaGGeeeeeGaaaaGGGGaaccccccaaaaaaacacccaaaaGGaaGGGaaaaaaDDmDDoogggggggodddwwwwwwoooDDDaaoaahhhaaaaDDGob
bGDDGGGGaaaaaGaaaaaaaaaaaaaaGGGeeeeGGGaaaaaaaaacccccaaaaaaaaacccaaaaGaaaGaaaaaaaowwwwwdogggggggoddwwwwwddooooooooooohhhoooooooob
bGDDaGGGGaaaaaGGGaaaaasaaaaaGGGeeeeGGGaaaaaaaaccccccaaaaaaaaaaGeeGGGGGaaGGaaacaaowwwwdddlllllllodwwwwddooooooooooooohhhoooooooob
bGDDaaaaGGGGGaaaGGaaccaaaaaaaaGeeeeGGGGGaaaaaaccccccaaaaaaaGGGaeeGGaaaaaaaaaacaadwwwwllllllllllllwwwlllllllllllllddwiiwddddddddb
bGDGGaaaaGaaaaGGGGaaccaaaaaaaaGGGGGGGGaGaaaaaaccccccaaaaaaGGaGaeeeGaaaaaaGaaaaaodwwwwllllllllllllwwwlllllllllllllddwiiiiwllllldb
bGGGaaGGaGaaaaaaaaaaaaaaaaaaaaGaaaaaGGaaaaaaaaccccccaaaaaGGGGeeeeeGGaacaaGaaaaagldwwwllllllllllllwwdlllllllllllllddwiiiiwllllldb
bGGGaaaGGGaaaaaaaaaaaaaaGGGGGaaaaaaaaaaaaaGaaaacccccaaaaaGaGGeeeeeGGaacaaaGaaaagldwwwllllllllllllwwwlllllllllllllddwwiiiwllllldb
bGGGGaaaaaaaaaaaaaaaaGGGGaaaaaaaaaaGaaaaaaGaaaacccccaaaaaGaGGeeeeGaaaacaaaGGaaaglddwwwlllllllllddwwwlllllllllllllddwiiiidllllldb
bGGGGaaacccccaaaaaGGGGGGaauacccccaaGaaaaaaGGGaacccccaaaGeeeeeeeeeGaaaaaaaaaGaaagldwwwwddddddddddddiwddddddddddddlldlliillllllldb
bGGGGaaacccccaaaaaaaaaGGGGaaaaaaaaaGGaaaaaaGGaacccccaaaGeeeeeeGGGGaaaaGaaaaaaaoglwrwrwwwwwwdddddddiwdwwwfdddddddlldlliillllllldb
bGDGGaaacccccaaaaaaaaaaaGGGaaaaaaaaaGaaaaaaaaaaccaaaaaaGeeeeeeGaGaaaaGGaaaaaaaowwwrwrrwwrrrrrwwwdwiwwwwwwwwwdddddlllliillllllldb
bGDGGaaacccccaaaaaacccaaaGGGaaaaaaaaGaacaaasaaaaaaaaaaaGGGeeeeGGaaaaGGaaaaaaaaodwwrrrrrrrrrrrrwwwwiwwddwwwwiiiiddllllllllllldddb
bGDDGaaaaaaaaaaaaaacccaaaaGaaaaaaaaaaaacaaaaaaaaaaaaaaaGGGGGGGaaaaaGGaaaaaaaaoodwwwwrrrrrrrrrrwwwdiwwdddwwwiiiiddllllllllllldddb
bGDGGaaGGaaaaaaGGGGGaaaaaaGaaaaccccaaaaaaaaaaaaacaaaaGGaaaaGGaaaaaGGaaaaaaaaDooddddwrrrrrrrrrriiiiiiwddwwwwwdddddllllllllllldddb
bGDGGaaGGaaaaaGGGGGGGGGGaaGaaaaccccaaaaaaaaGGaaacaaaaaGGGGGaaaaaGGaaccccccDDDodwwdddrrrrrrrrrriiiiiiwddfwwddddddddlllllllddddddb
bGDDGGGGaaaaaaGGGGGGGGGGaaGaaaaccccaaaaaaGGGaaaaaaaaaaaaaaaaaaGGGaaaccccccDDwwwwwwddwrwwwwwrrriiiiiiwwdwwwwdddddldlllllllddddddb
bGxDGGGGaaaaaaaaaaaaaaaaaaGaaaaaaaaauaGGaGaGaaaaaGGaaaaaaaaaaaaasaaaccccccaowwwwwwwdllllldwrrriiiiiirwwdwwwwiiddlllllllllddddddb
bGDDGGGaaaaaaaaaaaacccccaaaGGaaaaaaaaaaGGGaGGaacaaGGaaaaaaaaaauaaaaaaaaaaooodwwwwwwdlllllwwrrriiiiiirwwdwwwiiiddddlllldddddddddb
bGDGGGGaaaaaaaaaaaacccccaaaaaGaaGGGaGGGGGGGaGaacaaGGGGaaGaaaaaaaaaaaaaaaaoddwwwwdwwwlllllwwrrrrwddirwwwdwwiiiidddddddldddddddddb
bGDGGGGGaaaaaaaaaaaaaaaaaaaaaGGGGGGaGGaaGGGGGaaaaaaGGGGaGGaaaaaaaaaaaaaooodwwwllllwwwwwwwwwrrrrwwiiwwwddwwdddddddddddddddddddddb
bGGGGGGGGaaaaaaaaaaaaaaaaGaGGGGGGGGGGaGGGGGGGaaaaaaaaGGGGGGaaaaaaaaaaaaoddrwwwllllwwwwrrrrrrrrrwdriwwwwwwwdddddddddddddddddddddb
bGGGGDGGGGDDDDDDDDDGGDDDGGGGGGGGDDDDDDDDDGDDDDDCCCDDDDDDGGGGDDDDDDDDDDoodwwwwwlllldddwwwwwwrwwwwddiwwwwwwwiidddddddddddddddddddb
bGGGDDDGGGGGGGGDGGGGGDGGGGGGGDDDDDDDDCDDDDDDDDDDDDDDDDDDDDDGGGDDDDDDDDodwddwwwlllllllldwwddwwwwldwiwddwwfwwwdddddddddddddddddddb
bGGGGGGGGGGGGGGGGGGGGGGGGGGGGGGGGGGGGGGGGGGGGGGGGGGGGGGGGGGGGGGGGGGGGooddllllllllllllllllllllllliiiddddddddddddddddddddddddddddb
VXoooooooooooooooooooooooooooooooooooooooooooooooooooooooooooooooooooooddlllllddlllllllllllllllddddddddddddddddddddddddddddddddb
bbbbbbbbbbbbbbbbbbbbbbbbbbbbbbbbbbbbbbbbbbbbbbbbbbbbbbbbbbbbbbbbbbbbbbbbbbbbbbbbbbbbbbbbbbbbbbbbbbbbbbbbbbbbbbbbbbbbbbbbbbbbbbbb
bbbbbbbbbbbbbbbbbbbbbbbbbbbbbbbbbbbbbbbbbbbbbbbbbbbbbbbbbbbbbbbbbbbbbbbbbbbbbbbbbbbbbbbbbbbbbbbbbbbbbbbbbbbbbbbbbbbbbbbbbbbbbbbb
"}
