//MAP CONVERTED BY dmm2tgm.py THIS HEADER COMMENT PREVENTS RECONVERSION, DO NOT REMOVE
"a" = (
/turf/open/floor/rogue/dirt,
/area/rogue/outdoors/rtfield/hamlet)
"b" = (
/obj/structure/flora/roguegrass,
/obj/structure/roguerock,
/turf/open/floor/rogue/grass,
/area/rogue/outdoors/rtfield/hamlet)
"d" = (
/obj/structure/chair/bench/ancientlog,
/obj/structure/flora/roguegrass/thorn_bush,
/obj/item/restraints/legcuffs/beartrap/armed/camouflage,
/turf/open/floor/rogue/dirt/road,
/area/rogue/outdoors/rtfield/hamlet)
"e" = (
/turf/open/floor/rogue/dirt/road,
/area/rogue/outdoors/rtfield/hamlet)
"g" = (
/obj/structure/chair/bench/ancientlog,
/turf/open/floor/rogue/dirt/road,
/area/rogue/outdoors/rtfield/hamlet)
"h" = (
/obj/structure/flora/roguegrass/thorn_bush,
/obj/item/restraints/legcuffs/beartrap/armed,
/turf/open/floor/rogue/grass,
/area/rogue/outdoors/rtfield/hamlet)
"l" = (
/obj/structure/table/wood/treestump{
	pixel_x = -7
	},
/turf/open/floor/rogue/grass,
/area/rogue/outdoors/rtfield/hamlet)
"o" = (
/obj/structure/flora/newleaf/corner{
	dir = 6
	},
/turf/open/floor/rogue/dirt/road,
/area/rogue/outdoors/rtfield/hamlet)
"r" = (
/obj/structure/flora/roguetree,
/turf/open/floor/rogue/grass,
/area/rogue/outdoors/rtfield/hamlet)
"t" = (
/obj/structure/fluff/sellsign{
	desc = "The sign reads: RODE CLOSED GO LEFT"
	},
/turf/open/floor/rogue/dirt/road,
/area/rogue/outdoors/rtfield/hamlet)
"u" = (
/obj/structure/flora/newleaf/corner{
	dir = 5
	},
/turf/open/floor/rogue/dirt/road,
/area/rogue/outdoors/rtfield/hamlet)
"v" = (
/obj/structure/chair/bench/ancientlog,
/obj/structure/flora/newleaf/corner{
	dir = 9
	},
/turf/open/floor/rogue/dirt/road,
/area/rogue/outdoors/rtfield/hamlet)
"w" = (
/turf/open/floor/rogue/grass,
/area/rogue/outdoors/rtfield/hamlet)
"x" = (
/obj/structure/flora/roguegrass/thorn_bush,
/turf/open/floor/rogue/grass,
/area/rogue/outdoors/rtfield/hamlet)
"y" = (
/obj/structure/flora/newleaf/corner{
	dir = 9
	},
/obj/structure/flora/roguegrass,
/turf/open/floor/rogue/dirt/road,
/area/rogue/outdoors/rtfield/hamlet)
"z" = (
/obj/effect/spawner/roguemap/tree,
/turf/open/floor/rogue/dirt,
/area/rogue/outdoors/rtfield/hamlet)
"A" = (
/obj/structure/chair/bench/ancientlog,
/obj/structure/flora/roguegrass,
/turf/open/floor/rogue/grass,
/area/rogue/outdoors/rtfield/hamlet)
"B" = (
/obj/structure/flora/roguegrass,
/turf/open/floor/rogue/grass,
/area/rogue/outdoors/rtfield/hamlet)
"D" = (
/obj/structure/flora/newleaf/corner{
	dir = 5
	},
/turf/open/floor/rogue/grass,
/area/rogue/outdoors/rtfield/hamlet)
"H" = (
/obj/structure/table/wood/treestump,
/obj/structure/flora/roguegrass,
/turf/open/floor/rogue/grass,
/area/rogue/outdoors/rtfield/hamlet)
"M" = (
/obj/structure/flora/newleaf/corner{
	dir = 5
	},
/obj/structure/flora/roguegrass,
/turf/open/floor/rogue/dirt/road,
/area/rogue/outdoors/rtfield/hamlet)
"O" = (
/obj/structure/flora/roguegrass,
/obj/structure/flora/roguegrass/thorn_bush,
/turf/open/floor/rogue/grass,
/area/rogue/outdoors/rtfield/hamlet)
"P" = (
/obj/structure/flora/newleaf/corner{
	dir = 9
	},
/turf/open/floor/rogue/dirt,
/area/rogue/outdoors/rtfield/hamlet)
"T" = (
/obj/structure/flora/newleaf/corner{
	dir = 10
	},
/turf/open/floor/rogue/dirt/road,
/area/rogue/outdoors/rtfield/hamlet)
"U" = (
/obj/machinery/light/rogue/campfire,
/turf/open/floor/rogue/grass,
/area/rogue/outdoors/rtfield/hamlet)
"V" = (
/obj/effect/spawner/roguemap/tree,
/turf/open/floor/rogue/grass,
/area/rogue/outdoors/rtfield/hamlet)
"W" = (
/obj/effect/spawner/roguemap/treeorbush,
/turf/open/floor/rogue/grass,
/area/rogue/outdoors/rtfield/hamlet)
"Z" = (
/obj/structure/flora/newleaf/corner{
	dir = 9
	},
/turf/open/floor/rogue/grass,
/area/rogue/outdoors/rtfield/hamlet)

(1,1,1) = {"
V
W
x
H
U
e
a
"}
(2,1,1) = {"
V
W
Z
A
b
e
e
"}
(3,1,1) = {"
V
z
M
v
T
t
e
"}
(4,1,1) = {"
z
P
g
u
o
e
e
"}
(5,1,1) = {"
a
u
d
y
a
B
w
"}
(6,1,1) = {"
a
h
A
D
B
r
w
"}
(7,1,1) = {"
w
r
l
O
w
w
r
"}
