//MAP CONVERTED BY dmm2tgm.py THIS HEADER COMMENT PREVENTS RECONVERSION, DO NOT REMOVE
"a" = (
/turf/template_noop,
/area/template_noop)
"b" = (
/obj/structure/fluff/railing/border{
	dir = 1
	},
/obj/structure/fluff/railing/border{
	dir = 8
	},
/obj/effect/decal/turfedge_neu{
	icon_state = "jagged"
	},
/obj/structure/fluff/railing/border{
	dir = 9
	},
/turf/open/floor/rogue/ruinedwood{
	icon_state = "horzw"
	},
/area/shuttle/supply)
"c" = (
/obj/structure/fluff/railing/border{
	dir = 1
	},
/obj/effect/decal/turfedge_neu{
	icon_state = "jagged"
	},
/turf/open/floor/rogue/ruinedwood{
	icon_state = "horzw"
	},
/area/shuttle/supply)
"d" = (
/obj/structure/fluff/railing/border{
	dir = 1
	},
/obj/effect/decal/turfedge_neu{
	icon_state = "jagged"
	},
/turf/open/floor/rogue/ruinedwood{
	dir = 1;
	icon_state = "vertw"
	},
/area/shuttle/supply)
"e" = (
/obj/structure/fluff/railing/border{
	dir = 1
	},
/obj/structure/fluff/railing/border{
	dir = 4
	},
/obj/effect/decal/turfedge_neu{
	icon_state = "jagged"
	},
/obj/structure/fluff/railing/border{
	dir = 5
	},
/turf/open/floor/rogue/ruinedwood{
	icon_state = "horzw"
	},
/area/shuttle/supply)
"f" = (
/obj/structure/fluff/railing/border{
	dir = 1
	},
/obj/structure/fluff/railing/border{
	dir = 8
	},
/obj/structure/fluff/railing/border{
	dir = 9
	},
/turf/open/floor/rogue/ruinedwood{
	icon_state = "horzw"
	},
/area/shuttle/supply)
"g" = (
/obj/structure/fluff/railing/border{
	dir = 1
	},
/turf/open/floor/rogue/ruinedwood{
	icon_state = "horzw"
	},
/area/shuttle/supply)
"h" = (
/obj/structure/fluff/railing/border{
	dir = 9
	},
/turf/open/floor/rogue/ruinedwood{
	dir = 1;
	icon_state = "vertw"
	},
/area/shuttle/supply)
"i" = (
/turf/closed/wall/mineral/rogue/wooddark{
	above_floor = null
	},
/area/shuttle/supply)
"j" = (
/turf/open/floor/rogue/ruinedwood,
/area/shuttle/supply/buy)
"k" = (
/turf/open/floor/rogue/ruinedwood{
	dir = 1;
	icon_state = "vertw"
	},
/area/shuttle/supply)
"l" = (
/obj/structure/fluff/railing/border{
	dir = 5
	},
/turf/open/floor/rogue/ruinedwood{
	dir = 1;
	icon_state = "vertw"
	},
/area/shuttle/supply)
"m" = (
/turf/open/floor/rogue/ruinedwood{
	icon_state = "weird1"
	},
/area/shuttle/supply/sell)
"n" = (
/obj/structure/fluff/railing/border{
	dir = 1
	},
/obj/structure/fluff/railing/border{
	dir = 4
	},
/obj/structure/fluff/railing/border{
	dir = 5
	},
/turf/open/floor/rogue/ruinedwood{
	dir = 1;
	icon_state = "vertw"
	},
/area/shuttle/supply)
"o" = (
/obj/structure/fluff/railing/border{
	dir = 1
	},
/obj/structure/fluff/railing/border,
/obj/effect/decal/turfedge_neu{
	dir = 4;
	icon_state = "jagged"
	},
/turf/open/floor/rogue/ruinedwood{
	icon_state = "horzw"
	},
/area/shuttle/supply)
"p" = (
/obj/machinery/light/rogue/torchholder{
	dir = 8
	},
/turf/open/floor/rogue/ruinedwood,
/area/shuttle/supply/buy)
"r" = (
/obj/structure/fluff/railing/border{
	dir = 4
	},
/turf/open/floor/rogue/ruinedwood{
	dir = 1;
	icon_state = "vertw"
	},
/area/shuttle/supply)
"s" = (
/obj/structure/fluff/railing/border,
/obj/structure/fluff/railing/border{
	dir = 8
	},
/obj/structure/fluff/railing/border{
	dir = 10
	},
/turf/open/floor/rogue/ruinedwood{
	icon_state = "horzw"
	},
/area/shuttle/supply)
"t" = (
/obj/structure/fluff/railing/border,
/turf/open/floor/rogue/ruinedwood{
	icon_state = "horzw"
	},
/area/shuttle/supply)
"u" = (
/obj/structure/fluff/railing/border{
	dir = 10
	},
/turf/open/floor/rogue/ruinedwood{
	dir = 1;
	icon_state = "vertw"
	},
/area/shuttle/supply)
"w" = (
/obj/structure/fluff/railing/border{
	dir = 6
	},
/turf/open/floor/rogue/ruinedwood{
	dir = 1;
	icon_state = "vertw"
	},
/area/shuttle/supply)
"x" = (
/obj/structure/fluff/railing/border,
/obj/structure/fluff/railing/border{
	dir = 4
	},
/obj/structure/fluff/railing/border{
	dir = 6
	},
/turf/open/floor/rogue/ruinedwood{
	dir = 1;
	icon_state = "vertw"
	},
/area/shuttle/supply)
"y" = (
/obj/structure/fluff/railing/border,
/obj/structure/fluff/railing/border{
	dir = 8
	},
/obj/effect/decal/turfedge_neu{
	dir = 1;
	icon_state = "jagged"
	},
/obj/structure/fluff/railing/border{
	dir = 10
	},
/turf/open/floor/rogue/ruinedwood{
	icon_state = "horzw"
	},
/area/shuttle/supply)
"z" = (
/obj/structure/fluff/railing/border,
/obj/effect/decal/turfedge_neu{
	dir = 1;
	icon_state = "jagged"
	},
/turf/open/floor/rogue/ruinedwood{
	icon_state = "horzw"
	},
/area/shuttle/supply)
"A" = (
/obj/structure/fluff/railing/border,
/obj/effect/decal/turfedge_neu{
	dir = 1;
	icon_state = "jagged"
	},
/turf/open/floor/rogue/ruinedwood{
	dir = 1;
	icon_state = "vertw"
	},
/area/shuttle/supply)
"B" = (
/obj/structure/fluff/railing/border,
/obj/structure/fluff/railing/border{
	dir = 4
	},
/obj/effect/decal/turfedge_neu{
	dir = 1;
	icon_state = "jagged"
	},
/obj/structure/fluff/railing/border{
	dir = 6
	},
/turf/open/floor/rogue/ruinedwood{
	icon_state = "horzw"
	},
/area/shuttle/supply)
"C" = (
/obj/machinery/light/rogue/torchholder{
	dir = 4
	},
/turf/open/floor/rogue/ruinedwood{
	icon_state = "weird1"
	},
/area/shuttle/supply/sell)
"E" = (
/obj/structure/fluff/buysign,
/turf/open/floor/rogue/ruinedwood,
/area/shuttle/supply/buy)
"F" = (
/obj/structure/fluff/sellsign,
/turf/open/floor/rogue/ruinedwood{
	icon_state = "weird1"
	},
/area/shuttle/supply/sell)
"T" = (
/obj/docking_port/mobile,
/turf/open/floor/rogue/ruinedwood{
	dir = 1;
	icon_state = "vertw"
	},
/area/shuttle/supply)

(1,1,1) = {"
a
a
o
a
a
"}
(2,1,1) = {"
a
f
o
s
a
"}
(3,1,1) = {"
a
g
o
t
a
"}
(4,1,1) = {"
a
g
o
t
a
"}
(5,1,1) = {"
b
h
k
u
y
"}
(6,1,1) = {"
d
j
j
j
A
"}
(7,1,1) = {"
d
j
j
j
A
"}
(8,1,1) = {"
d
E
j
j
A
"}
(9,1,1) = {"
k
j
p
j
k
"}
(10,1,1) = {"
T
k
i
k
k
"}
(11,1,1) = {"
k
m
C
m
k
"}
(12,1,1) = {"
d
F
m
m
A
"}
(13,1,1) = {"
d
m
m
m
A
"}
(14,1,1) = {"
d
m
m
m
A
"}
(15,1,1) = {"
c
k
k
k
z
"}
(16,1,1) = {"
e
l
k
w
B
"}
(17,1,1) = {"
a
n
r
x
a
"}
